навязывать: навязывать 
мантра: мантру 
звание: звания званием званиях 
любить: любит любить Люблю люблю любят 
принятие: принятия 
думать: Думала думала думаете думаю думали думаешь думая думал думают думать думай Думаю Думаем 
подход: подходы Подходы 
недочёт: недочеты 
занять: занял занять заняли 
самоотдача: самоотдача 
пить: пить 
правда: правду 
недавно: недавно 
сделать: Сделать сделаны сделаем сделать сделали сделано сделал сделают сделает 
фестиваль: фестивале фестиваль 
убеждение: убеждение 
сообщить: сообщена сообщил сообщили сообщила сообщило сообщены 
макларен: Макларена 
архив: Архив 
абсурд: абсурд 
штрафной: штрафных 
формирование: Формирование 
повышение: повышение повышения 
нейтрализация: нейтрализацию 
соратник: соратники соратникам 
польза: пользы пользу 
разъяснить: разъяснило 
овечкин: Овечкине Овечкин 
штык: штыками 
международный: международные международном международными Международного Международной Международным Международный международной международным международная Международная международного Международные международное международный международных 
изучать: изучать 
водный: водным водных Водные 
соревнование: соревнование соревнованиях соревнований соревнованиями соревнованиям 
загнать: загнали загнал загнать 
стакан: стакан 
учиться: учились учился Учитесь учиться учитесь 
война: война войн войной войны войну Война 
обучаться: обучался 
призовой: призовые призовыми Призовые 
печенег: печенеги 
повелитель: Повелитель 
лапочка: лапочка 
высокий: высших Высшая Высшей высокую высшее высокие высшей высока высшем Высшую Высокая высоком высокий высокого 
стать: стало стала Стали стали стал станет стать станут 
тот: Ту та тех тому ту те теми Те Та 
наименование: наименование 
фехтование: Фехтование фехтовании фехтование 
юниор: юниоров юниором 
футбольный: футбольные футбольная футбольный футбольное футбольного футбольном футбольной футбольным футбольных 
сообщать: сообщает 
ситуация: ситуацию ситуациям ситуация ситуацией 
двенадцать: двенадцать 
пять: Пять пяти пять 
отпустить: отпустить 
приходиться: приходилось приходится 
менять: менять меняет 
бейсбол: Бейсбол 
победитель: победители победителем победитель победителей победителя победителями 
коллега: коллег коллеги коллегой коллегами коллега 
раздавать: раздает раздают 
альпина: Альпин 
подойти: подойти 
душа: душу душ 
товрняк: товрняк 
огребать: огребают огребать 
выигрывать: выигрывать выигрывает Выигрывая выигрывай 
изучить: изучить изучи Изучим изучили изучите 
слесарь: слесарей 
добить: добьем 
поселение: поселения 
украсть: украсть украденный украл украли 
решиться: решится 
соизволить: соизволят 
борьба: борьбой Борьба борьбу борьба борьбы борьбе 
товарняк: товарняк товарняки 
наркоз: наркозе 
хит: Хита Хит 
позитивный: позитивно 
туризм: туризма 
дверь: дверь 
дисквалифицировать: дисквалифицировать дисквалифицировали дисквалифицирован дисквалифицировала 
наш: наше нашем нашу наша нашего наш Наш наших Наша нашей нашим нашему наши Наши нашими 
бриллиантовый: Бриллиантовую Бриллиантовая 
указывать: указывать 
нож: нож ножом 
достойный: достойных достойную достойного достоин достойные 
результат: результаты результатом результату результатам результат Результаты результатов результате 
вообще: Вообще вообще 
опубликовать: опубликовано опубликовал Опубликовал опубликован 
главенство: главенство 
увеличить: увеличили увеличены увеличат 
обещание: обещаний 
явный: явный явные 
кореш: кореша 
плеваться: плеваться 
стрелять: стреляет стрелять стреляла 
виссарионович: Виссарионовича 
четвёртый: четвертый 
юный: юный юных юным 
главный: Главные главный Главный Главная главные главному главных главная 
крупно: крупно 
бразильский: Бразильский бразильский бразильские 
довести: довести довели 
многополярный: многополярном 
активный: активному активных 
квадратный: квадратных 
совершенно: совершенно 
сильный: сильнейшие сильные сильный сильнее сильнейших сильныйа сильная сильных 
давать: даем дает дают давай Давайте давайте давала давать 
венгрия: Венгрия 
скажем: Скажем скажем 
доллар: долларов доллару доллара 
культура: культура культуру культуре культурой Культура культуры 
хотеть: хотел хотим хотят хочу хочешь хотела Хотели хочет хотите Хотела хотели Хочу Хотим Хотел 
задуматься: задуматься 
технический: техническая техническом техническим техническое 
борт: бортом 
предпочтение: предпочтениям предпочтений предпочтение 
запись: запись 
вершина: вершина вершины 
сотня: сотней сотне сотен сотня сотню 
пытаться: пытались пытаются пытаемся пыталось пытаясь Пытаются пытается 
пользоваться: пользуются пользуется пользуетесь 
близкий: близок ближайшее ближе 
всу: всу ВСУ 
вагнер: Вагнер вагнера 
разочарование: разочарования 
заявить: заявив заявили заявил заявила 
комфортный: комфортным 
территория: территориях территорий территорию территориями территории 
перемирие: перемирие перемирия 
первый: первому Первого первым первая первом первее первую первые Первый Первой первый Первые первого первых первыми первой 
другой: другими другим других другая ДРУГОЕ другого Другое другому другие Других другое другую 
провалить: провалив 
нянчиться: нянчится 
делать: делала делал делали делает Делаю делать делаете Делай делаю делая делают 
запад: западом запад Запада запада Западом Западу западу Запад 
райзену: Райзену 
народ: народами народов народ народы Народу 
президент: Президента президентом президенту Президенту Президент президента президент президенты президенте 
происходить: происходил Происходит происходит происходят происходить 
какой: какую Какие каком каких Какую Каким каким какие Каких какого 
великий: Великой великих Великий Величайшая великой величайшая Великая 
клуб: клубах клуб клуба клубам Клуб клубы клубу клубов 
заинтересованный: заинтересован 
содействие: содействие Содействия содействия 
лишение: лишение 
поворачиваться: поворачиваться 
этот: этими эта этих Эта 
буквально: буквально Буквально 
присылать: присылали 
пожать: пожали пожать 
прямой: прямое прямые прямую Прямая прямая прямых прямом 
навки: Навки 
узнать: узнать Узнал узнал 
вещать: вещает вещаете вещаешь вещать вещают 
государство: государствами государству государства государство государств государством 
первенство: первенства Первенства первенствах первенствами первенстве первенство 
полина: Полина 
правило: правилам правило правилах правил 
контракт: контракт контракты контракта контрактами 
отрасль: отрасль отрасли отраслей отраслью 
город: город городов городе города 
идея: идея идею идеями 
дата: дату дата даты 
прикидываться: прикидываешься 
телеканал: телеканал Телеканал 
издать: издан издано 
русофобский: русофобское 
относиться: Отношусь относится относились относиться относятся относящихся 
повестись: повелась 
чистый: чист чистая чистом 
нести: нести несли несут несет 
оштрафовать: оштрафовал оштрафован оштрафовать 
рупор: рупор 
уволить: уволили уволен Уволенный уволенный 
весь: вся всем всеми Всему весь Весь всему 
оспорить: оспорил оспорить 
организация: организациями организации организациям Организации организацию организация организаций организацией 
разжигать: разжигает 
команда: Команды команду Команда команда команде командами командой команд Команду команды 
поплавать: поплавать 
правительство: правительствами Правительства Правительство правительствам правительство правительством правительств правительства 
совесть: совести 
поразить: поражен 
тюмень: Тюменью Тюмень Тюмени 
интеллект: интеллект интеллекта 
пловец: пловец Пловец пловцов 
логически: логически 
хотеться: хотелось хочется Хочется 
школа: школы школу школе школ школах 
рождение: Рождения рождения 
пробить: пробить 
постараться: постараться постараются постараюсь постараемся 
банить: баним 
мост: мосты мостом 
преимущество: преимущество 
американский: американский американского американским американских Американский 
смочь: смог Сможете сможешь Смогут сможете смогли смогла сможем смогут сможет 
повторно: повторно 
нефть: Нефть нефть 
количество: количеством Количество количества количество количестве 
высказываться: высказываются 
интересный: поинтересней интересное интереснее Интересный интересные интересных 
скриньте: Скриньте 
отрезать: отрезали 
нарушить: нарушила нарушили нарушил 
угол: угол 
год: годы году лет годах Год Годом годов годом года год 
студент: Студенты 
заварить: заварил 
круглов: Круглов 
составлять: составляет составляют 
знаменитый: знаменитый 
заменить: заменить заменен заменили Заменить 
тащить: тащат 
палестинский: палестинское палестинские Палестинскими 
крекс: крекс 
список: списку список 
судья: судьи судьями судей судья 
показательный: показательный 
привыкнуть: привыкли привык 
номер: номере номер номером номера 
жесть: Жесть жесть 
мировой: мировыми Мировой мировой мировых мировую мирового мировое мировые 
человек: человеку людях людьми Человек человеком человек человеке людей людям Люди человека люди 
сходить: сходил Сходил 
заметить: заметили замечен заметил заметим 
антон: Антон Антону 
одиночка: одиночка 
увидеть: увидел увидеть увидели увидите 
дальнейший: дальнейшие дальнейшего дальнейшем 
задний: заднем заднюю 
предусмотреть: предусмотрено Предусмотрено 
стесняться: стесняясь стесняюсь стесняются 
блатной: блатные 
беспокойство: беспокойство беспокойством 
объединение: объединение объединении объединением 
тетрагидроканнабинол: тетрагидроканнабинол 
функционировать: функционирует 
село: села 
тренировочный: тренировочного тренировочный тренировочных 
круто: Круто круто 
создать: создана создал созданных создать 
место: место места местом мест Место месте 
хрен: хрена 
сегодняшний: Сегодняшние сегодняшний сегодняшних сегодняшнего 
спортсменка: спортсменку спортсменок спортсменкой 
чётко: четко 
рубль: Рубли рублях рублей 
куча: куча 
повтор: повторе повторами 
соуза: Соуза 
понимание: понимании 
бродить: бродили 
регламент: регламент регламента 
масса: масса масс массу 
планироваться: Планируется планируется 
палец: палец 
принять: принято приму примут приняли примет принял принять 
похожий: похож 
зонный: зонную 
лозунг: лозунгом лозунги лозунгах лозунгами лозунг лозунгов 
вознести: вознесет 
превосходить: превосходят 
полномочие: полномочия 
качнуться: качнулось 
десятилетие: десятилетие десятилетиями 
церковь: церковь 
ущербный: ущербными 
мешать: мешал мешает 
остаться: Осталось оставшиеся останется осталось оставшееся Остался останусь остались осталась остаться остался 
сложный: сложная сложный Сложная сложному сложные 
довольствоваться: довольствоваться 
пропасть: пропало пропал 
знать: знаешь знаем Знаю знают знали знал знаете знала Знаем знать знает знаю 
республика: Республика республики республикой Республики 
согласно: Согласно 
оценивать: оценивать 
отличать: отличали отличает 
тень: тень 
радостно: радостно 
каждый: каждую Каждый каждая каждому каждом каждого каждым каждый 
прогнить: прогнила 
способный: способны 
фаткулина: Фаткулина 
прокатить: прокатит прокатило 
вождь: вождя 
обязанность: обязанностей 
кроме: Кроме кроме 
ставка: ставка Ставка ставку 
уверенность: уверенности уверенность 
национальность: национальностей национальностям 
уаф: УАФ 
регион: регионе регионам регионов регионы региона региону регионах регионами 
поступление: Поступление поступление поступлении поступления 
забивать: забивать забивали 
поменяться: поменяется 
четвертьфинальный: четвертьфинальный 
макаров: Макаров 
путин: путину Путина Путин Путину Путине Путиным 
преднамеренно: преднамеренно 
запрет: Запрет запреты запрет запрете 
уменьшиться: уменьшилась уменьшилось 
улица: улица улиц улице 
ведомство: ведомствам ведомство 
включение: включения включении 
адамс: Адамсу 
насмотреться: насмотрелся 
хороший: хорош лучший лучшие хорошая хорошую хорошее лучшего лучших лучшим хорошему хороших лучшее Хороший хороший хорошего хороши хорошие хорошем Хорошая 
история: историю история историй 
футболист: футболиста футболистах футболистами футболистов футболисты футболистам футболисту футболист Футболисты 
один: одно одном Одно одними одну одна одним Одна одних 
миллион: миллионов миллионам миллионы миллиона 
болтать: болтали 
поработать: поработать поработал 
университет: университеты 
иркутск: Иркутск 
рука: рука руку руками рук руки 
получить: получить получит получил получишь Получили получили 
программа: программа программе программам программу программой программ 
соперник: сопернике соперника соперники соперниками соперник сопернику соперникам соперников соперником 
такой: такую таких Такого Такое Таких Такие такими такого такое таким ТАКАЯ такая таком такие 
оборона: обороне 
пятёрка: пятерке 
отправить: отправлен Отправить отправить 
четвёрка: четверки четверку четверка 
доставлять: доставляют 
родный: Родная родную родная 
мвц: МВЦ 
рейх: Рейхе 
акула: Акула 
аутентификация: аутентификация 
подавать: подавать 
рабочий: рабочую рабочим рабочая 
бабиков: Бабиков 
турнир: Турнир турнира турниров турнир турнирах турнире турниры турниру турнирам Турнира 
судейство: Судейство судейство 
сосиска: сосисок 
трансфертный: трансфертную 
отношение: отношению отношений отношение отношениях отношении 
обсуждать: обсуждать обсуждал Обсуждаем обсуждают 
замечание: замечание 
выезд: выезда выезде 
фигурный: Фигурное фигурном фигурного фигурному 
вид: вид виды видах видов вида виде видам 
характер: характера 
снести: снести снес 
повторный: повторном 
голкипер: Голкипер 
дикий: дикие Дикое Дикая 
тренировка: тренировку 
залов: заловом 
канадец: Канадцев Канадцы 
расписаться: расписался распишутся расписались распишется 
агент: Агенты агенты 
день: днях день дня днем 
ставропольчанка: ставропольчанки 
турбо: Турбо 
англичанин: англичанами 
держаться: держалось держится 
смотреть: смотрело смотрите Смотреть смотреть смотрит Смотрю 
петербургский: Петербургском петербургский петербургскому 
намерить: намерены намерено 
пожаловаться: пожаловался 
намекнуть: намекнул 
испания: Испанией Испании Испания 
коэлью: Коэлью 
тяжёлый: тяжелый тяжелая тяжелее Тяжелая 
единый: единую Единой единой 
украина: Украине Украину Украина Украины Украиной 
тайна: тайнах 
кутузов: Кутузов 
халява: халяву 
рассказ: рассказ 
лыжня: лыжне 
странно: Странно странно 
казнь: казнь 
липецк: Липецк Липецка 
соколов: Соколову Соколов Соколова Соколовым 
италия: Италии Италия 
сбежать: сбежал 
попробовать: попробовать Попробовали 
бредить: бредите бредит 
государственный: государственного государственной государственных государственным Государственная государственный государственную 
игра: игр Игра игрой Игр игре игры играм играх Играм Игру игру игра Игры Играх 
бедро: бедро 
нагадить: нагадил нагадили 
алина: Алина Алиной 
перевести: переведен 
нахлобучить: нахлобучу 
мать: матери 
аркадий: Аркадий 
абсолютно: Абсолютно абсолютно 
измир: Измир Измира 
лицо: лицам лиц лицом лицу лице 
право: праве право правах прав права Права правом правам 
правление: правления правление 
жертва: жертва 
разойтись: разошлись 
обмазываться: обмазывались 
двустульностью: двустульностью 
недруг: недругам 
девать: девать 
четверной: четверные 
который: которая которого которые которое который котором которую которых которому которыми которым 
перенести: перенесены перенес 
вовремя: вовремя 
внук: внуки внуков внуками 
замылить: замылить 
ходить: ходить ходил ходишь Ходила ходит 
соответствующий: соответствующими 
зарядить: заряжена заряжены 
перерасти: переросло 
товарищеский: товарищеский товарищеских Товарищеская товарищеские Товарищеский Товарищеские товарищеском 
сербия: Сербия Сербии Сербию 
второй: второму второго вторые вторая вторую Вторые вторых втором вторым 
целый: целые целую 
задеть: задел 
утопать: утопаете 
почему: Почему почему 
реестр: реестры реестра 
поржать: поржать 
картинка: картинку Картинка 
сомневаться: сомневающийся сомневается сомневаюсь сомневался 
причина: причинах причине причину причина Причина причинам причин 
признать: признан признал признано признали признало признаны признать 
активно: активно 
сиб: Сиб 
умилять: умиляет 
рубеж: рубеж рубежа рубеже рубежом 
бывать: бывает бывают Бывает 
абзац: абзаце 
спорт: спорте Спорт спорту спорт спорта спортом 
подписать: подпишут подписать подписал подписали 
поведение: поведение поведению 
выборы: выборах выборами Выборы выборам 
глаз: глазах глаза 
новогорск: Новогорске 
регламентный: регламентную 
особенно: особенно Особенно 
научный: научные 
ролевый: ролевыми 
меняться: меняется меняются 
российский: Российские российская российское российской Российской российском Российским российскими российских российскому Российского российский российские российскую российского российским Российский Российское 
вынудить: вынуждены вынуждена вынужден 
дружественный: дружественными 
штаб: штаба штаб штабом штабу 
осознать: осознать осознал 
сохраняться: Сохраняется сохраняется 
дудка: дудку 
неплохо: неплохо 
электронный: электронном электронные электронный Электронные электронно электронную электронных электронного Электронный 
сократить: сократили сократите 
дзюдоист: дзюдоист дзюдоистах 
проверять: проверять 
правый: правы Правому 
показать: Показать покажет показал показать показала показанную показали покажем 
выпить: выпив 
работать: работали работающие работал Работал работает работающая Работаем работают работать работая 
тревожить: тревожит 
досрочно: досрочно 
реклама: Реклама 
удаться: удалось Удалось 
отвечать: отвечаешь отвечает отвечают 
лишний: лишние лишних 
оправдать: оправдать 
братан: братан 
объект: объекта объектов 
именно: именно Именно 
менее: менее 
бокс: Бокс бокса боксу 
следующий: следующая 
лидер: лидера лидеру лидеры лидерами Лидерами лидер 
ребёнок: детей Дети ДЕТЕЙ детям детьми дети 
теплота: теплотой 
председатель: председатель председателем 
использовать: использовать Использовали использует 
оплачивать: оплачивать оплачивают 
баста: Баста 
завестись: завелось завелась 
совет: Совет совет Совета совету Советов 
отсылка: отсылка 
отстранение: отстранение отстранении отстранением 
уходить: уходит уходили уходят уходи 
выдавать: выдавать 
царапина: царапинам 
власть: власти власть властей властью 
большинство: большинстве большинство большинства 
известный: Известный известных известны известный Известны 
благодарить: благодарит благодарить Благодарю 
порядочность: порядочность 
себя: собой собою 
максимально: максимально 
копейка: копеек копейки 
шахта: шахтах 
прорыв: прорыв прорывах 
бой: бою боем боя бое 
лауреат: Лауреат лауреатов Лауреатов 
долбать: долбают 
фон: фоне 
выплатить: выплатит 
исторический: исторических исторический 
искать: искать ищут ищи 
избрать: избран избрали 
подбирать: подбираем 
депутат: Депутат депутаты депутатам депутат депутатов 
перерыв: перерыва перерыве 
лаборатория: лаборатория 
пушистый: пушистый 
информационный: информационная информационные информационной 
коррупция: коррупцию 
шахматный: шахматный 
идеологический: идеологическую 
одновременно: одновременно 
коллектив: коллективам коллектив коллектива коллективы коллективом 
прожить: прожил прожили 
променять: променяет променяют 
серьёзный: серьезные серьезная серьезную серьезному 
потрясать: потрясающая Потрясающая 
литр: литра литр 
притягивать: притягивают 
разрезать: разрезали 
разобраться: разобраться 
случай: случае случаев случай случаях случаи 
мутко: Мутко 
зазнаваться: зазнавайся 
старт: старты старт стартах Старт 
гордость: Гордость гордость 
проблема: проблему проблеме проблем проблема проблемам 
рига: Рига Риге 
фляга: фляга 
паства: паству 
ученик: ученики учеников 
отрезок: отрезок 
навку: Навку 
москва: Москвы Москве Москва 
видеть: видим видела видеть видел вижу видит видели 
сеть: сети 
новый: новую новом новыми новая новые новой Новая Новую Новой Новый новых нового новый 
планета: планете планеты 
публикация: публикации 
даниил: Даниил 
рассказать: Рассказал рассказал расскажет 
группа: группе Группа группа группах группы группами 
русановке: русановке 
ошибиться: ошиблись 
октябрь: Октябрь октября 
полный: полные полную полному полное полного полный полная 
выступление: выступлений Выступление выступлением выступлениям выступление выступлении 
забыть: забудут забыл 
болеть: болеют болеть болеет болит болел 
избежать: избежать 
гаванистов: гаванистов 
сигнев: Сигнев 
вмешательство: вмешательство вмешательством вмешательства 
интересно: интересно Интересно 
знак: знаком 
пляжный: пляжному Пляжный 
перминов: Перминова 
кнр: КНР 
слово: словами словах словам слову слове слово Слово слов 
ответить: Ответить ответить ответят ответил 
газпром: Газпром газпрома газпром 
кровь: крови 
искусственный: искусственного Искусственные 
категория: категории 
легионер: легионеров 
половина: половиной половине половина половины 
сам: самими самих сама сами само 
лоббировать: лоббировали 
политический: политическую политический политическое политическими политической политическая политических политическому политическим политические политического Политическим 
число: числе 
внутренний: Внутренняя 
елена: Елена 
размазать: размазать 
футбол: футбола футболе футболом Футбол футболу футбол 
мотивация: мотиваций мотивация 
зима: зима 
подлый: подлый 
папа: папу папа 
отдать: отдали отдать отдаст 
надеяться: надеемся надеялись надеются Надеялись надеюсь Надеюсь Надеемся 
вашингтонский: вашингтонский 
пропальщиков: пропальщиков 
урок: урок 
традиция: традиция 
шеф: шефа 
рекорд: рекорды рекордов рекорд 
утянуть: утянуть 
управление: управления управлению управление 
встретиться: встретилась встретится встретился встретятся встретиться встретились 
стероид: стероидах стероиды 
реальность: реальность реальности 
гойда: гойда 
объединить: Объединенный объединить 
лектор: лектора 
отказаться: откажитесь отказаться отказалась отказались отказался откажется 
канал: канале каналу каналах канал канала 
бросать: бросай 
продемонстрировать: продемонстрировать 
стойка: стойке 
проделать: проделали 
газета: газета газету газеты газет газетами 
параллельный: параллельные 
трансляция: трансляций трансляцию трансляция трансляции трансляциях 
самостоятельно: самостоятельно 
заслужить: заслужила заслужить 
отборочный: отборочного 
троить: Троя троя 
каунас: Каунасе 
элемент: элементов 
забавно: Забавно 
астана: Астана 
скидка: скидкам 
расшифровка: расшифровку 
сомнительный: сомнительное 
единственный: единственные единственный единственной Единственный единственная 
хоккеист: хоккеисты 
континентальный: континентальных 
цинизм: цинизм 
трава: траве 
пройтись: пройдитесь 
конец: конец конце конца 
устать: уставшие 
генерация: генерация генерации генерацией генерацию Генерация Генерации 
мечтать: мечтаю 
трезвый: трезвый 
победа: победу Победу победа победой побед Победы победе победы 
этап: этап этапе этапа 
деньга: Деньги деньги денег 
сообщаться: Сообщается сообщается 
учесть: учел 
зачёт: зачета 
упоминать: упоминать 
лещук: Лещук 
каста: касте каста касту 
джет: джетах 
массив: массиве 
кассационный: кассационную 
препарат: препараты препарат препаратами 
защищать: защищает защищайте защищали 
усмонов: Усмонов 
образовательный: образовательных образовательный 
хлеб: хлеба 
колокольня: колокольни 
взнос: взносах взнос 
бутылка: бутылках бутылке бутылку 
тохар: Тохаром 
идеально: идеально 
укреплять: укреплять 
больной: больные болен 
зенит: Зениту зенит Зенит 
союзный: Союзного 
снг: СНГ 
беззубый: беззубые 
выразить: выразил выразили выразить выразила 
мощно: мощно 
политика: политике политики Политики политика Политика политику 
минута: минуте Минуту минут минуты минуту 
понятие: понятие понятия 
исправить: исправьте 
взяться: взялась взялись 
разный: разным разными разные разных разного 
проводить: проводят проводил проводили проводить проводимых проводит 
победить: победит победило победим победил победили победить победила победив 
грузин: грузины 
наказание: наказание 
написать: написали написанном написать написал напишите написанную написано 
московский: московской московскому московская московское Московская московского 
министр: министра министром министров министр министру Министру Министр 
восторжествовать: Восторжествует восторжествует восторжествуют восторжествовать 
переиграть: переиграла переиграли переиграв 
номинация: номинации номинаций номинациях номинация 
россия: Россия России Россию Россией 
евгений: Евгений Евгения 
сложно: сложно 
нежиться: нежась 
вводиться: вводится 
лишить: лишены лишили лишить 
россиянин: россиянину россияне россиян россиянах Россияне россиянами Россиянам россиянам 
красавец: красавцы 
сокращение: сокращение Сокращение сокращения 
отдельный: отдельную отдельная отдельное 
деревня: деревни деревню 
европа: Европе Европа Европы 
внезапно: внезапно 
сюда: сюда 
кёрлинг: керлинга Керлинг 
льготный: льготный льготное 
считать: считают считаю считать Считаю считали считая считающий считает 
прислать: пришли 
попахивать: попахивает Попахивает 
приниматься: принимается приниматься 
самодостаточный: самодостаточная самодостаточны 
успешно: успешно 
товарищ: товарищу товарищ товарищи 
процедура: процедуры 
испанец: испанцев испанцы испанцами 
достигнуть: достиг достигли 
замерзать: замерзающими замерзал 
национальный: национальной национальный Национальная Национальной национальные национальная Национальную национальных национальному 
должный: должны Должен должен должна Должна должно 
белый: белый бело белым белыми белому Белый 
выглядеть: Выглядит выглядело выглядеть выглядят выглядит выглядел 
отстранять: отстраняет отстранять Отстраняем 
компонент: компонентах компоненте 
договор: договоров договор договоре 
брат: братьев братьями братья 
проживать: проживая проживают 
литва: Литве Литва Литвы 
резерв: резервы резерва 
кристина: Кристина 
речь: речах речью речь речей речи Речь 
израиль: Израиле Израилю израиля Израиль израиль израилем Израиля 
вдвойне: вдвойне 
выкрутиться: выкрутиться 
что: чему 
переживать: переживают переживал 
проиграть: проигравшему проиграть проиграл проиграла проиграли 
градус: градуса градусов 
гниль: гниль 
вторжение: вторжения 
огромный: огромные огромная огромную огромный Огромное огромное 
занятый: занят 
общий: общих Общий общий общем общей 
проявляться: проявляется 
направление: направление направлений направлении направлениям направления 
жить: живут жить жил живем Жили Жить жили живу 
атаковать: атакующую атаковав 
вратарь: вратаря вратарь Вратари вратарю вратари Вратарь 
смысл: смысле смыслах смысл 
закономерный: закономерен Закономерный 
комбинация: комбинаций 
приковать: прикованы 
твой: твои твоем твое твоего 
участник: участники участника участников участникам 
несмотря: Несмотря несмотря 
совковый: совковый 
отменить: отменить отменили 
шарлатан: шарлатан 
вбахивать: Вбахивать 
снять: Снять сняты 
нобелевский: Нобелевской 
бухенвальд: Бухенвальд 
начальник: Начальник начальником начальника начальник 
дебил: дебилов 
состав: состав состава составе составу составах составы 
владимир: Владимир Владимира Владимиром 
фабрика: фабрикам фабрики 
организовывать: организовывавшие организовывают организовывать организовывал 
краснодар: Краснодара 
бомбардир: бомбардир бомбардиром 
чёткий: четкого четкое 
палата: палаты палате 
невозможный: невозможны 
разница: разнице Разница разница 
назвать: назвать Назову назови назвал 
тысяча: тысячи тысяч 
входить: входил входит входят 
олимпиада: Олимпиаде Олимпиаду Олимпиады Олимпиад олимпиады Олимпиада олимпиадах 
терять: терял теряя 
начинаться: начинался 
крах: Крах крах крахом 
букмекер: букмекеров букмекеры 
единоборство: Единоборства единоборства 
начаться: начнется началась началось 
ишков: Ишков 
закон: закон законам Закон закона Законы законы законами закону 
присвоить: присвоенные присвоили 
патриот: патриотам патриоты патриот патриоте 
биатлон: Биатлон биатлон биатлона биатлоне биатлону 
неизменный: неизменна 
отстранить: отстранен отстранит отстранили Отстранили отстранены отстраненные отстранить отстранил 
русофобия: русофобия 
выступать: выступать выступаем выступают выступая выступающих Выступать выступающему выступающие выступает 
чиновник: чиновникам чиновником чиновники чиновников 
критерий: критериями критерию критерии 
неважно: неважно 
узбекистан: Узбекистана Узбекистан 
украинский: Украинская украинскими Украинской украинское украинский Украинские 
азиатский: Азиатские 
прочитать: прочитала Прочитай прочитать прочитанное прочитал 
заложник: заложники заложниках 
готовый: готовый готова готовы готово готовыми готов Готовы 
глубокий: глубокие глубже 
четвертьфинал: четвертьфинал четвертьфинале 
рада: Рада рады 
поручение: поручению поручение 
насчитываться: насчитывается 
физкультура: физкультурой физкультуры 
минимальный: минимальная 
эквадор: Эквадор 
зато: зато Зато 
черта: чертами черт 
смущаться: смущаясь 
алрос: АЛРОСА Алроса 
возможный: возможные возможный возможной возможным возможных возможного 
дань: Даней 
медиафутбола: медиафутбола 
пример: примеру примеры пример примере 
свой: своих своя своего своими свое своем свои свой 
скорость: скорость 
последний: последний последнем последним последней Последнее последнего последних последнее ПОСЛЕДНИЕ последняя Последний последние 
мове: мове 
помощь: помощь помощью 
воздействовать: воздействовать воздействуя 
изобиловать: изобиловала 
форма: Форму форме форм формы форма 
любушка: Любушка 
успеть: успеть успел успели 
пояснительный: пояснительной 
взыскание: взыскании 
официальный: официальном официальному официальное официальный Официальный официального официальных 
вуз: вузы ВУЗ вуз 
делегация: делегаций делегация делегации 
разумеется: разумеется Разумеется 
бездна: бездну 
успокоиться: успокоятся 
повестка: повестку повестке 
послушный: послушное 
отличаться: отличается отличаются 
краткосрочный: краткосрочном 
понять: понял поймет пойму поймут понять понята 
продукция: продукцию 
воспоминание: Воспоминаний 
умереть: Умер умер 
заокеанский: заокеанскими 
заверить: заверить заверил 
извлечь: извлечет 
протяжение: протяжении 
акцент: акцент 
проглотить: проглотит проглотили 
мгу: МГУ 
допустить: допущены допустить допустите допустят допустили 
раскрываться: раскрываться 
мерить: меряешь 
слава: слава Слава славу славы 
вызвать: вызвано вызвана 
достижение: достижениями достижение достижений достижения 
европеец: европейцы европейцев 
уровень: уровне уровень уровня уровню Уровень 
делец: дельцами дельцов 
участие: участии Участие участием участия участие 
сгнивать: сгнивать 
спокойно: Спокойно спокойно 
движение: движении движению движение движения 
всплакнуть: всплакнул 
партия: партию партия партии 
ничейный: ничейный ничейному 
медведев: Медведев 
ирония: Иронии иронии 
атмосфера: атмосферой атмосфере Атмосфера 
восьмеро: восьмерых 
штамповать: штамповать 
аут: АУТА аут 
вторгнуться: вторглись 
статья: статьи статьями статью 
отметить: отметить отмечу отметил Отметим 
прогноз: прогноз прогнозы Прогноз Прогнозы 
родственник: родственниках родственникам 
заявка: заявке Заявка заявок заявкой 
карьера: карьере карьеру карьеры карьера 
комментировать: комментировать комментирую 
развернуться: развернулось развернуться 
конкретный: конкретным конкретных конкретного 
конкурентоспособность: конкурентоспособности 
продукт: продуктам продукта продукты продуктами 
родина: родиной Родина Родины родины родина 
руководитель: Руководители руководителем руководителями 
молчать: молчать молчите молчу молчит 
услышать: услышать услышали 
топ: топе топами 
начать: начать начнут Начнем начнем начал начнет начато Начал начали 
русский: русское Русскому Русского Русским русского русский русскому русским русские Русские русских русском Русский 
поддержание: поддержанию 
технология: технологий 
антисемитский: антисемитские 
человечек: человечку 
воля: волю 
прочий: прочими Прочие прочие прочих 
являться: являются является являющегося являться являлись 
свищев: свищев Свищев 
представительство: представительств 
совместить: совмещенные 
признаться: признался 
гранд: Гранд грандах 
финал: финалов финал Финалах Финала Финал финала финале 
уголовный: уголовное уголовной уголовную 
чемпион: чемпиону чемпион Чемпион чемпионами Чемпионом чемпионов чемпиона Чемпионы чемпионом чемпионы 
увеличиваться: увеличивались 
вылет: вылетом 
невинный: невинном 
очевидный: очевидные очевидной 
фора: форе форам фору 
сыграть: сыграют сыграет сыграл сыграть сыграли сыграла 
сняться: снялась снялся сняться снимется 
латвийский: латвийских латвийским Латвийский латвийский 
вторник: вторник 
нарушать: нарушает нарушай 
сообщество: сообществом сообщество 
кремлев: Кремлев 
зэк: зэков 
месяц: месяц месяца 
отбор: отборе отбор 
золото: Золото золото золота 
хамас: хамас Хамас ХАМАС 
нигде: нигде 
мысль: мыслями мысль 
лига: лига Лиги лиг лиги лиге Лига лигой Лигу Лиге лигу 
дыра: дыру дыра 
выступить: выступят выступили выступила выступит выступил выступить 
говорить: Говорит Говорили говорите говорю говорил Говорим говоришь говорит говоря говорили говорить говорят Говорят 
возможность: возможность возможностей Возможность 
повторить: Повторить повторит повторить 
талон: талоны 
геннадий: Геннадий 
выделить: выделило выделить выделила 
хилаля: Хилаля 
чемпиен: чемпиен 
включать: включает включать 
всероссийский: Всероссийского всероссийских 
объявить: Объявлен объявили объявить объявят объявлено Объяви 
выйти: вышла Вышел выйти выйду выйдет выйдя выйдут вышли 
грозить: грозить грозит 
ваш: ваша ваши вашему Ваша вашу ваше ваш ваших вашего 
необязательный: необязательные 
франция: Франции Франция 
объём: объеме объем 
финансово: финансово 
курс: курс курсе 
допуск: допуску допуск допуска допуске допусков 
друг: друзьям друг друзья Друзья друзьях друзей друга другу 
реальный: реальная реального 
мфл: МФЛ 
пломбир: пломбир Пломбир 
пара: Пара пары пара пару 
песок: Песков 
трудоустройство: трудоустройства трудоустройству 
зависеть: зависит зависят зависеть 
пустить: пустят 
кэф: кэф 
тренер: тренером тренеров тренерам тренеры тренера тренерами тренеру тренер 
яусталяухожу: яусталяухожу 
хоккей: хоккею хоккея хоккее Хоккей хоккей 
американец: американцев Американцы 
иск: иски иску 
обращаться: обращаюсь Обращаясь обращались 
сбор: сбор Сборы сборе сбора сборы 
заработать: заработают заработав 
братский: братская 
призёр: призеров призера призер призером 
перевыполнить: перевыполнены 
лоб: лбу 
упаковка: упаковка 
враг: врага враг 
стащить: стащить 
подумывать: подумывал 
впечатление: впечатлениями впечатление впечатлениях 
секунда: секунды секунд 
никакой: Никаких никакого Никакого никаких никакую никакой никакие 
алиев: Алиев Алиева 
мфк: МФК 
миранчука: Миранчука 
бумажка: бумажке 
функционер: функционерам функционера функционеров функционеры 
незаконно: незаконно 
получиться: Получится получилось получился получится 
предоставить: предоставлено предоставила 
столичный: столичные 
засчитать: засчитано 
сфера: сферах сферу сфере сферы 
новосибирский: Новосибирский новосибирского 
плечо: плечах 
войти: войти войдет вошли 
нассать: нассать 
парад: парадом парадах парад парада парады парадов 
дед: деда 
киев: Киева Киеве 
регулировать: регулируют 
бобслей: Бобслей 
рыбак: рыбака 
лишь: лишь 
проситься: просятся 
козлов: Козлов Козлова 
особый: Особое Особый особом особый 
федерация: Федерация федераций федерации федерациями Федерации федерацией федерация 
большой: велика большом большое Большого побольше большого большому 
представить: представьте представил представили представлены представить представит представлено 
палладий: палладий 
учебный: учебно учебное учебные 
гореева: Гореева 
дин: ДИНА Дина 
енисей: Енисея Енисей 
цена: цена ценою 
катание: катанию катание катания катании 
ограничение: ограничений ограничении ограничение 
добавить: Добавим добавить добавили добавил добавлена Добавить 
зарабатывание: зарабатывания 
наивный: Наивные 
начальница: начальница 
назначение: назначение 
рукопожатие: рукопожатие рукопожатий 
блюдо: блюдо 
угода: угоду 
упасть: упала упали упал 
екатеринбургский: Екатеринбургская 
запутать: запутанная 
погибнуть: погибло погибли погиб 
подвести: подвела подвел подвести подвело 
собираться: собирается собираюсь собиралось собирались 
дядя: дядя дядю Дядя 
высоко: высоко 
элекс: Элекс 
оскорблять: оскорбляешь 
множество: множество 
путаница: путанице путаницы 
исторически: исторически 
удмурт: Удмурт удмурта 
работа: работу работы работе работа 
митя: Митя 
открытие: открытие открытии Открытие открытия 
финальный: финального финальной Финальный 
классный: классных Классный классное 
кузнецов: Кузнецов 
перспектива: перспективой перспективе перспектив перспектива 
рома: Рома 
половец: половцы 
отзыв: отзыве отзыв отзывы 
василиевич: Васильевич 
контекст: контексте 
абсолютный: абсолютный 
португальский: португальское португальская португальский 
судьба: судьбы 
стоять: стояла стояли стоял стоять 
мотив: мотивам мотивов мотивы 
бедный: бедное бедные беднее 
играть: играл играешь играем играла Играли играли играют играет играть 
проведение: проведение проведения 
побуждать: побуждают 
возвращать: возвращают возвращать 
волноваться: волновался 
обыграть: обыграна обыграла обыграли обыграл обыграло Обыграв 
небольшой: небольшая небольшую небольшого небольшим 
заключение: заключения 
будущее: будущем будущее будущего 
север: Север 
директор: директора директору директор директором 
внутренним: внутренниму 
дефицит: дефицит 
кирилл: Кирилл 
чемпионат: чемпионате чемпионатах чемпионатам чемпионаты чемпионат Чемпионате Чемпионату Чемпионат чемпионатов чемпионата Чемпионата 
стыковка: стыковкой 
заставлять: заставлять Заставлять заставляют 
управлять: управлять 
декларация: декларацию 
чемодан: чемоданы 
саратов: Саратове Саратов Саратова 
сборная: Сборная сборную сборной сборная 
ногинск: Ногинске 
разнос: разнос 
зарабатывать: зарабатывать 
военный: военных военное Военные военными военного 
ничто: ничем ничему 
ягудин: Ягудин 
путёвка: путевку 
уведомление: уведомлений уведомления 
гимнастка: гимнастки 
процент: процентов проценты 
хореограф: хореографом 
компания: компании Компании 
мокнуть: МОК мок 
организовать: организовали организует организована организовать организуете 
кричать: кричали кричит 
баскетбол: баскетбол Баскетбол 
порядок: порядка порядок порядку порядке 
париж: Парижа Париж Парижем Париже 
конкуренция: конкуренции конкуренция конкуренцию 
рубрика: рубрика 
музыка: музыку 
навсегда: навсегда 
прилив: прилив 
предложение: предложениями предложению предложение 
индия: Индия Индией 
мучить: мучает 
доугрожались: ДОУГРОЖАЛИСЬ 
позволить: позволили позволило позволил позволит 
иметь: имеют иметь имеешь имеете Имею имела имеет имеем 
соблазн: соблазны 
утвердить: утвержден утвердило утвержденных 
потихоньку: потихоньку 
флаг: флаг флагами флагом флаге Флаг Флага флага 
уступить: уступили уступил уступила уступило 
мистер: мистер 
раздел: раздел 
пропустить: пропустили пропущенные пропустил Пропустили пропустит 
псина: псину 
стадион: стадионах стадион стадионе 
апрель: апреле апреля 
объединять: объединяет объединяющая объединяющую 
беженец: беженцы беженцев беженцами 
заголовок: заголовки 
удовлетворить: удовлетворены удовлетворен 
пользователь: пользователей Пользователь пользователю пользователем 
прудников: Прудников 
малый: малый меньших 
дом: дом дома Дому 
бизнес: бизнес бизнесы бизнеса 
конгрессмен: конгрессмен 
прослушать: прослушали 
интернет: Интернет интернет интернете 
социальный: социальный социальными социальных 
появиться: появилось появились появилась появился Появились появятся 
воображать: воображаемом 
уйти: Ушел ушла уйти ушли уйдет 
серб: Сербы сербов сербы 
монголия: Монголия Монголии 
областной: областные 
игор: Игор 
обстоятельство: обстоятельств обстоятельствах обстоятельства 
крепостной: крепостные Крепостные 
олимпийский: Олимпийских олимпийскую олимпийских олимпийский олимпийским Олимпийском олимпийская Олимпийским олимпийскими Олимпийская Олимпийские олимпийское Олимпийскому олимпийские Олимпийский Олимпийскими олимпийскому олимпийского Олимпийского 
собственный: собственных собственное собственные 
отсчитываться: отсчитывается 
создавать: создаем создавать создавал создавали 
утиль: утиль 
боком: боком 
мир: мира мире миру мир Мир миром Мира Миру 
критически: Критически критически 
поиск: поиске поиск поиска 
одержать: одержала 
переименовать: переименовало переименовали переименован 
возвращение: возвращение Возвращение возвращения возвращению 
доктор: доктор 
чистота: чистотой 
дорога: дорог 
увеличиться: увеличилось 
равный: равны равные 
диплом: дипломами диплом 
оправдываться: оправдываться 
золотой: золотых золотые золотая золотую Золотую 
высококлассный: высококлассных 
общество: общества 
без: безо 
уверенный: Уверен уверен 
бомбить: бомбить 
пропаганда: пропаганда пропаганду 
аппарат: аппарат 
понимать: понимаешь понимаю Понимали понимать Понимать понимала понимаете понимает понимал понимая понимают 
выходить: выходил выходить выходили выходит выхожу 
вне: вне 
ум: уме умом ума 
сила: сила силой силам силу сил силы 
учитывать: учитывать учитывая Учитывая 
нужный: нужен нужные нужна нужны 
телефон: телефону телефоне 
формировать: формируют формировать 
подтвердить: подтвердит 
значит: Значит значит 
освещать: Освещают 
сенатор: Сенаторов 
физкультурник: физкультурников 
чересчур: чересчур 
василича: Василича 
иосиф: Иосифа 
всяческий: всяческую 
вопрос: вопросов вопросы вопроса вопросам вопросу Вопрос вопрос вопросом вопросах 
профессиональный: профессиональные профессиональный профессиональной профессиональных 
сво: сво СВО 
валерий: Валерий 
претендовать: претендовала претендовать претендуют 
декабрь: декабря 
рекомендательный: рекомендательные 
фирс: Фирсов 
де: де 
оля: Оле 
шанс: шанса шансы шанс Шансы шансов 
иван: Иван 
анфиса: Анфиса 
проявить: проявим проявили 
нейтральный: нейтральных нейтральный нейтральном 
счёт: счетом счет счете 
африка: Африка Африки 
генсек: Генсек 
вредительство: вредительством 
кубок: Кубок Кубка кубок Кубке 
ес: Ес ЕС 
серия: серию серий серии 
эффективный: эффективнее эффективная эффективные эффективное 
ограничиваться: ограничиваться 
сотрудничество: сотрудничестве сотрудничество сотрудничества 
модераторомна: модераторомна 
дружить: дружить дружили 
информация: Информация информацию информации 
окружение: окружению 
прыгать: прыгают Прыгай прыгает 
победный: победного победном победный 
царствие: Царствие 
полька: польку 
успех: успехе успехам успех успеха успехах успехом 
меньшинство: меньшинстве 
семинар: семинар 
западный: западного западных западные 
офигевает: офигевает 
лиссабон: Лиссабону Лиссабоне 
дать: даст дан дадут дали дал дать дайте 
развитие: развитии развития развитию развитие 
пройти: пройдут прошло пройдена прошла пройдет прошли прошел пройти Прошло 
расположение: расположение 
закупка: закупку 
подъезд: подъезде подъезда 
реализовать: реализовано реализовали 
махнуть: махнуть 
основа: основе основой 
участвовать: участвовать участвовала участвовали участвуем участвуешь участвует участвуя участвую участвуют 
завидовать: завидует 
раскачка: раскачку 
чикунова: Чикунова 
исполнитель: исполнителей 
закрытие: закрытия 
жемчужина: жемчужиной 
подобие: подобии подобие подобию 
курировать: курирует 
возвращаться: возвращается возвращаются 
восьмой: восьмым 
коммунизм: коммунизм 
давить: давит давили 
встать: встала 
жопа: жопу жопой 
мария: Мария Марии 
стрелочка: стрелочка 
приезжать: приезжайте 
общность: общность 
план: плану плане план планами 
любитель: любителей 
оттуда: оттуда 
прекрасно: прекрасно Прекрасно 
решение: решения решениях решением решении решений решение решениями Решение 
косторная: Косторная 
кикие: кикие 
морда: мордой 
грабить: грабит 
михайлов: Михайлов 
подготовиться: подготовься подготовиться 
основатель: основателем 
тренерский: тренерского тренерский тренерскому 
любой: любому любом любые любое Любое любого любая любую любых 
содержать: содержать содержали 
прутковый: Прутков 
сопоставимый: сопоставимыми 
представление: представлении представления 
униат: униаты 
задача: задача задаче задачи Задача задачами 
рекомендовать: рекомендовано Рекомендуемая 
умственный: умственная 
удовлетворение: удовлетворение 
принципиально: принципиально 
прийтись: придется Пришлось пришлось 
опыт: опыт опыта опытом 
никель: никелем никелю никель никеля Никеле 
зимний: зимних зимние зимнего зимний 
достаться: достаться достанется 
негатив: негатива 
имя: имени имя именам 
бьорндалена: Бьорндалена 
натереть: натерла 
вольный: волен 
фраза: фразу фраза фразами 
угроза: угрозе угрозой угрозами 
кадр: кадров 
чехия: чехии Чехия 
корона: корону 
комитет: комитетом комитет комитета комитеты комитетов комитету 
брать: берут брать 
похулиганить: похулиганить 
пробиваться: пробиваются 
рядом: рядом 
июль: июле июля 
следовать: следует 
разделение: разделения 
продолжать: продолжать продолжаю продолжала продолжает продолжают 
нацист: нацисты 
богатый: богатый богаче 
дегестанцев: дегестанцев 
повлиять: повлияло повлиять повлияют 
центральный: центральный Центральный 
выражать: выражал Выражаем 
возраст: возраст возраста возрасте возрасту 
министерство: министерство Министерства Министерство 
сразиться: сразиться 
предпочитать: предпочитает 
усилить: усилить 
молодец: молодцы молодец Молодцы 
итог: итоге итогов итоги итогами итогам итог 
латыш: Латышей латыши латышами 
никто: никого НИКОГО никому Никто никем никто 
комплекс: комплексе комплекс 
изолировать: изолировать 
отнимать: отнимают 
православный: православные 
крайний: крайней 
народец: народец 
поиграть: поиграть 
преувеличивать: преувеличивать 
признание: признание признанием 
льгота: льготам льготы льготе льготах 
рассчитывать: рассчитывать Рассчитывали рассчитывают рассчитывали 
украинец: украинцам украинцы Украинцы 
оказывать: оказывать 
получать: получают получала получаешь получает получать получали 
смешной: смешна 
уважаемый: уважаемый 
посол: послом 
заболевание: заболевание 
нравиться: нравилась нравится 
уважение: уважении уважения уважение 
запрещать: запрещал запрещаем запрещают 
постзнанием: постзнанием 
похвала: похвалу 
нидерланды: Нидерландах Нидерланды 
шея: шее 
ольга: Ольга 
передовой: передовых 
ряд: ряд 
северный: Северная Северной 
апоэл: АПОЭЛ 
выход: выход выходы выхода 
слышать: слышать слышал слышим слышали 
каеф: Каеф 
палестина: Палестине Палестина Палестины 
ангел: Ангелу 
вложить: вложила вложено вложенных 
медиалига: Медиалига 
душить: душит 
разделять: разделяют разделяет 
преодолеть: преодолеть преодолеет 
пожалеть: пожалели 
производить: производят производить 
местный: местными местный местных Местный местном 
забрать: забрать 
наука: науки науку науке 
нация: наций нации 
функциональный: функциональной 
константин: Константина Константин 
сибиряк: сибиряка Сибиряком сибиряки Сибиряк Сибиряка Сибиряку 
заявление: заявлении заявление заявления 
искренний: искренние искренняя 
кодекс: кодексу кодекса 
интенсивный: интенсивная 
проверка: проверку Проверка 
свимрану: свимрану 
блинкены: Блинкены 
неспособный: неспособна 
мощный: мощную мощный 
режим: режиме режима 
идеал: идеале 
фигурка: фигурка 
контент: контент 
лидировать: лидирует лидирующие лидируют 
присутствовать: присутствуют присутствовали 
кыргызстан: Кыргызстаном Кыргызстан Кыргызстана 
сказать: скажу скажут Скажут сказали скажет сказано сказать сказала скажешь сказал 
иностранец: иностранцев 
дружба: Дружбы дружбы дружбу 
никита: Никита Никитой Никиты 
шесть: шести шесть Шесть 
жать: жмут жать 
геноцид: геноцидом геноцид 
наворотить: наворотили 
дождаться: дождался 
миссия: миссия 
списать: списана 
гимн: гимном гимн гимне гимна 
соответствие: соответствие соответствии соответствия 
оборудование: оборудования 
атлет: атлеты атлетов атлетах 
рязань: Рязань 
номинант: номинантах 
отменять: отменяя отменять 
вица: Вице вице 
вмешиваться: вмешиваться 
питание: питание 
сохранить: сохранена 
двухфакторная: двухфакторная 
засуетиться: засуетились 
бояться: боятся боюсь боялись бояться 
сторона: стороне сторона стороны сторон сторону Стороны 
гватемала: Гватемалу 
босния: Босния 
гаскойн: гаскойн 
воспринять: воспринято 
интенсивно: интенсивно 
утюг: утюгов 
текст: тексте текст 
сказаться: скажется 
вернуть: вернуло вернуть вернем 
голова: Головой головой голова голову головы 
прекратить: прекратить 
угомонить: угомонить 
состязание: Состязание 
улучшение: улучшения 
есть: ест 
белорусский: белорусские белорусских белорусского белорусское 
индивидуальный: индивидуальной индивидуальных индивидуальную Индивидуальные 
вода: вода воды воду воде 
гражданин: гражданина гражданином граждан гражданин гражданами граждане 
погода: погоду 
поселить: поселить 
бороздить: бороздят 
отмена: отмене 
сборный: сборных 
помогать: помогайте помогает помогаем помогал помогают помогали 
плакать: плачет 
кирпич: кирпичами 
расписание: Расписание расписанию расписания 
деятель: деятелей деятели Деятели 
бикс: БИКС 
гарантировать: гарантировал гарантировать гарантируют 
заныть: заноешь 
забег: забегах 
португалия: Португалии Португалия Португалию Португалией 
присвоение: присвоению 
палестинец: палестинцев Палестинцами Палестинцев Палестинцы 
приз: приз призы 
роль: роль 
сказка: Сказка сказок 
поймать: пойманному 
архаика: архаику 
установить: установил установлена 
тонкость: тонкостями 
наглядный: наглядную 
соблюдение: соблюдении соблюдением 
вспонился: вспонился 
цирк: цирка 
абама: абама 
взять: взял взяла возьми взять взяли взяло взят 
физический: физической физическую физических 
руководство: руководству руководством 
повесить: повесить 
ждать: Ждут Ждем ждет ждут ждать ждали жду ждем 
камил: Камилу 
собрать: собрал собраны собрано Соберите 
надеть: надеть надел 
блин: блин блины 
выстроить: выстроил 
грознинцы: Грознинцы 
температура: температура температуры 
завершать: завершала завершать 
закончить: закончить закончил закончим 
усилиться: усилился 
внести: внесены 
переход: переходе перехода переходов 
оно: Оно оно 
попросить: попросила попросить Попросил попросит 
плановый: плановом 
спросить: спросил спросите 
поединок: поединки поединке поединок поединка Поединок 
летний: летнего летние Летняя 
вляпаться: вляпался вляпаться 
носить: носить носил 
уметь: умеем умеешь уметь умеют 
двойной: двойными двойного двойных 
легко: легко 
определять: определять определяет 
капитан: капитан Капитан 
страна: страну страны странах странами Стране Страна стране стран странам страна Страны 
касаться: касаются касается 
балл: баллы 
полностью: полностью 
корректно: корректно 
краснодарский: Краснодарское 
премия: премию Премия премия премий премии 
нок: НОК 
графический: графическим 
синекура: синекуру 
тактический: тактическом тактическими тактические 
истерия: истерию 
сгонять: сгонять 
цитата: цитатой цитата цитаты 
распоряжение: Распоряжение 
сынок: Сынок 
евро: ЕВРО евро Евро 
большунов: Большунов 
точка: точка точку точкой точки 
запроситься: запросишься 
ничей: ничье 
аргументировать: аргументируя 
трек: трек 
отделиться: отделиться 
смешно: Смешно 
послушать: послушал послушать послушайте 
выполнение: выполнения 
указать: указаны укажут Укажите указано 
логика: Логика логика 
дурак: Дураков дураки дурак 
роднина: Роднина 
кормить: кормить кормят кормит 
строчка: строчку строчка строчке 
ухватиться: ухватиться 
настоящий: настоящим настоящий настоящую настоящее настоящие настоящему 
смех: смеха 
восемь: восьми 
школьный: школьные 
уделять: уделяет уделять 
журову: Журову 
живой: жива живом живыми 
мочь: могут Могу могла мог могли можем могло можете могу Могли можешь 
волнение: волнение 
швейцарский: швейцарские 
аргентинец: Аргентинцы 
гатчина: Гатчине 
непонимание: непонимания непонимание 
январь: января январь январе 
завоевать: завоевал завоевала завоевать завоевали 
ясно: Ясно 
активность: активность 
два: Две две 
нью: Нью 
несколько: Несколько несколько 
климатический: климатические 
мониторинг: мониторинг 
мышеловка: мышеловке 
обсуждение: обсуждение 
вывезти: вывезли 
диссоциативное: диссоциативное 
дима: Дима 
удивить: удивил 
доказывать: доказывает 
договориться: договорились 
бахнуть: бахнула 
легитимность: легитимность 
разгромить: разгромила разгромил разгромлен 
одолеть: одолела одолел одолевшая одолело 
увести: увел 
включить: включены 
гроб: гробу 
неделя: неделю недели неделе неделями 
мохамед: Мохамед 
сосед: соседями 
ффр: ФФР 
заместитель: заместитель 
байлс: байлс 
пас: пасах Пасу 
представитель: представители представитель представителей Представители 
спортсмен: спортсменов спортсменам спортсмены Спортсмен спортсмена спортсмен спортсменами Спортсмены 
среди: среди 
измельчать: измельчает 
изоляция: изоляцией 
эскердинья: Эскердинья 
врать: врет врать врал врут 
конфликт: конфликтов конфликты конфликт конфликта 
руководить: руководят руководит руководить 
шантаж: шантаж 
легенда: легенда 
андреев: Андреев Андреева 
развалить: развалить 
авось: авось 
внимательно: внимательно 
тайм: Тайм тайма тайме тайм 
химки: Химки Химках Химок 
несправедливый: несправедливо Несправедливые несправедлив 
заклинать: заклинал 
оформить: оформил 
экзамен: экзамен 
матч: Матчи матч матча матчи матчей матче Матч матчем матчах 
беркут: Беркут 
справиться: справились справилась 
тема: тему теме 
гс: ГС 
закрадываться: Закрадывается 
ужасный: ужасное 
специальный: специальная специальное 
войско: войска 
чрезмерно: чрезмерно 
командировка: командировки 
восточник: Восточники восточники 
призыв: призывов призыве призывы 
таковой: Таков таков 
рассадить: рассадив 
обколоть: обколотый 
чинуша: чинуш 
пострадать: пострадала пострадает 
условный: условному условным 
миллиардер: Миллиардер 
австралия: Австралия 
проспект: проспектам проспекту 
потребление: потребления 
заслуга: заслуга 
открыть: открыли Открой 
норма: нормой норма норм норму 
отсутствие: отсутствии отсутствие отсутствия 
константинов: Константинов 
ын: Ын 
умолчать: умолчал 
частность: частности 
свежий: свежие 
выкинуть: выкинешь 
решить: решена решила решим решить решили Решил решил решат 
условие: условий условиями условия условиях 
найти: найти найдут найдешь найдите 
поздравлять: поздравляю поздравляет Поздравляю поздравлять поздравляемому поздравлял 
мощь: мощь 
шарип: Шарип 
развязка: развязка 
август: августа августе 
сработать: сработал сработали сработала 
фантасмагория: фантасмагорию 
подобать: подобает 
ставропольский: Ставропольский Ставропольского Ставропольские 
грузинка: грузинка 
заветный: заветный 
проверить: Проверьте проверил проверить 
цитировать: цитирует 
метр: метрах метров 
некорректно: некорректно 
ассист: ассист 
пенсия: пенсий пенсию 
поэма: поэме 
глава: главы Глава главе главу глава 
спортивный: спортивные Спортивная спортивное спортивного спортивную спортивных спортивным спортивный спортивном спортивная 
плавание: плавание плавании плаванию 
борис: Борис 
быть: Будем будешь буду Буду будем будьте будь будут 
отстоять: отстояла 
кремль: Кремля 
подпись: подписью 
маевский: Маевский 
бойкот: бойкот 
сергей: Сергея Сергею Сергей 
буква: буквой 
культурный: культурные культурном 
исполнение: исполнения 
здравоохранение: здравоохранение здравоохранения 
требовать: требуем требует требовать 
новгород: Новгород Новгорода 
зал: зале залах 
обладать: обладают обладает обладая 
говно: говном говне 
стандарт: стандарты стандартов стандартах стандарта стандарт Стандарт стандартами стандартам 
теннис: теннис Теннис 
обжечься: обжечься 
биполярный: биполярное 
документооборот: документооборот 
открывать: открывал открывает 
кехра: Кехра 
напоминать: напоминает Напоминаем 
защита: защите защиту защиты 
старикан: старикана 
индивидуально: индивидуально 
рад: рад 
гибридный: Гибридная 
скоро: Скоро скоро 
тошнить: тошнит 
наиболее: наиболее 
старый: старый старым старые 
прибегать: прибегая 
универсиада: Универсиаде Универсиада 
словакия: Словакия Словакии 
насильно: насильно 
киптум: Киптум 
гордиться: гордиться гордится гордились Горжусь 
политизировать: политизированные политизировал 
обращение: обращение обращении 
исключение: исключении исключениях исключения 
мнение: мнения мнением мнению мнение 
получение: получение получении получения 
бабочка: бабочку 
самый: самые Самая Самый Самое самых самыми самая самым Самые самое самую самый 
гаванизм: гаванизм 
повториться: Повторюсь 
пригласить: пригласил пригласили пригласить 
старец: старцы 
появляться: появляется появляться появлялся появлялись появляются 
минь: Мини мини 
казахстан: Казахстана Казахстаном Казахстан 
серьёзно: серьезно 
лошадь: лошади 
сегодня: Сегодня сегодня 
помочь: помочь помогли поможет помог 
порядочный: порядочным 
госкдарством: госкдарством 
считаться: считаются считается 
рейтинг: рейтинг рейтинги рейтингу 
законодательный: законодательном законодательной 
обрести: обрели 
нечего: нечем нечего 
суперлига: Суперлиге суперлиги суперлиге Суперлига Суперлигу Суперлиги 
минималку: минималку 
внешний: внешнего внешнем внешним 
кенийский: кенийские 
эксперт: экспертов 
мавзолей: мавзолея мавзолей 
необходимый: необходимым необходимыми необходимые 
серебряный: серебряных серебряным серебряную серебряного серебряными 
наводить: наводят наводить наводит наводите 
чита: Чита 
больница: больниц больницы больницах 
посмотреть: Посмотреть посмотреть посмотрите посмотрим 
айрат: Айрат 
максимальный: максимальном максимальных 
налицо: налицо Налицо 
пьер: Пьер 
безотносительно: Безотносительно 
круг: круга круги кругу круге 
чёрный: черная Черную 
общатся: общатся 
телекартинке: телекартинке 
вдвое: вдвое 
разрываться: разрываешься 
алиночка: Алиночка 
поддерживать: поддерживаем поддерживает поддерживала поддерживают поддерживать 
липовый: липовыми 
смена: смену смены смене 
барс: Барсы 
огласить: огласить 
завязать: завязан 
свет: свете 
приятный: Приятная 
заикаться: заикался 
юридический: юридической 
вещь: вещей вещах вещами 
согласный: Согласен согласен согласны 
глупо: глупо 
достойно: достойно 
соблюдать: соблюдают соблюдающий соблюдает соблюдать соблюдали соблюдаем 
колбаса: колбасой 
супербоул: Супербоул 
дармоед: дармоедов 
несовершеннолетний: несовершеннолетнему несовершеннолетних 
полиция: полицию полиция 
хоть: Хото 
наличие: наличием наличию 
особо: особо 
телевизор: телевизора 
анкетирование: анкетирования 
организационный: организационном 
азербайджанец: азербайджанцев 
выбираться: выбираться 
расти: рос расти растет 
внедрение: внедрении внедрение 
беларусь: Беларусь Беларуси 
беспокоить: беспокоит беспокоить 
соответствовать: соответствует соответствовать соответствуют 
брейк: брейке 
ответственность: ответственность 
действие: действие действий действиях 
метар: Метар 
представлять: представлять представляла представляющие Представляя представляет Представлять 
варьироваться: варьировалось 
земля: земли земле Земля 
лидерство: лидерством 
анаболический: анаболические 
вброс: Вброс 
брита: Бриту 
уехать: уехал уехала 
исполнить: исполнила 
преследование: преследования 
квалификационный: квалификационному квалификационном 
германия: Германии Германией германия 
основное: основном 
утратить: утратило 
готовиться: Готовлюсь готовится готовились готовилось 
распределять: распределяет 
воспитанник: Воспитанник воспитанников 
сожаление: сожалению 
верблюд: верблюд 
санитар: санитары 
николаев: Николаева 
инфляция: инфляцией 
приехать: приедет приедут приехать 
длиться: длится 
шакир: Шакиров 
талант: талант талантам талантов 
нуждаться: нуждаются нуждается 
нестыковочка: нестыковочка 
персонаж: персонаж 
возмущаться: возмущается возмущаешься 
бажин: Бажин 
поход: походу Походу 
отток: оттока 
трейла: трейла 
писать: пишет писала пишем Пишите писал писать 
роналду: Роналду 
выявить: выявило 
светлана: Светлана Светлану 
порадоваться: порадоваться порадовались 
трибуна: трибун трибуне трибунах 
прессинг: прессинга 
топовый: топовые 
прыжок: прыжкам прыжках 
побаиваться: побаивался побаивается 
ненец: ненцы 
обеспечить: обеспечат обеспечить обеспечив обеспечим обеспечила 
отреагировать: отреагировать 
нить: нить 
квалифицироваться: квалифицировались 
приблизительно: приблизительно 
характеризоваться: характеризуется 
чувствовать: чувствовала Чувствую чувствовать чувствую 
проводиться: проводиться проводится проводился 
низкий: низкий 
перебраться: перебраться 
бессмысленный: бессмысленная 
пустой: пустое пустые 
настроение: настроение настроением настроения 
лесгафт: Лесгафта 
либеральный: либеральный 
независимость: независимости независимость 
признавать: признают признаю 
избежание: избежание 
пиво: пиво пиве 
реализация: реализации реализация 
рб: РБ 
смертный: смертные 
подать: подали 
вынести: вынести вынесет 
название: Название названием название 
законодательно: законодательно 
ярко: ярко 
бронза: бронза бронзу 
болельщик: болельщиков болельщик болельщиках болельщики болельщика 
советский: Советский советский советское 
сплясать: сплясать 
современный: Современное современных 
жизнь: Жизнь жизни жизнь 
вничью: вничью 
многие: многие Многие 
огуречный: огуречный 
трансфер: трансфера 
постановить: постановила 
человеческий: человеческая человеческой человеческих 
азов: Азовам 
тупо: тупо 
жорж: Жорже 
отправлять: отправляй 
камила: Камилой 
постоять: постойте 
действовать: действующими действовать действует действуют 
иранский: иранском иранских 
развиваться: развиваться развиваются 
одинаковый: одинаковая 
бункер: бункере 
троллинг: троллинг 
ритм: ритме 
поступить: поступило Поступило поступить 
высказаться: высказался 
время: Времени времени время Время 
недвижимость: недвижимости 
екатеринбург: Екатеринбурге Екатеринбург 
терроризм: терроризма 
сапрыкин: Сапрыкина Сапрыкин 
нередкий: нередки 
разбирательство: разбирательство 
этнический: этническая этнические этническую этнических 
нормальный: нормальная нормальный нормальных нормальные нормальным Нормальные 
серебро: серебро серебре 
мелочиться: мелочиться 
кубковый: кубковую 
вмешаться: вмешались 
плюс: плюсы 
передний: переднем 
уход: уходе уход 
дорогой: дорогие 
пшик: пшик 
сайт: сайт сайте 
трансфермаркт: трансфермаркт 
пермь: Перми 
саммит: саммита 
поверить: поверила поверить 
тяжело: Тяжело тяжело 
башкортостан: Башкортостане 
забить: забили забьет забив забить забил 
винтовка: винтовками 
придумать: придумает придумаете придумать придумаешь придумают 
катарец: катарцев 
искренне: искренне Искренне 
расстояние: расстояния 
тиливезеру: тиливезеру 
эпоха: эпоху 
надежда: надежде надежду 
рисковать: рисковать рисковали 
амстердам: Амстердаме 
мвд: МВД 
организатор: Организаторы организаторам 
допинг: допинге допинг допингу допинга допингом 
глушаков: Глушаков 
небо: небес 
убыток: убытков Убытки убытки 
называться: называются называется 
азербайджан: Азербайджан 
курить: куришь 
андрей: Андрея Андрей андрей 
собеседник: собеседник 
посчитать: посчитали 
хартия: хартию Хартия хартия 
журналист: журналистами журналистов журналистом журналист 
показатель: показателей показатели показателям 
испугаться: испугался 
штат: штатах 
повод: повод поводу 
португалец: Португальцы португальцы Португальцам португальцев 
чистосердечный: чистосердечное 
бюджетник: бюджетников бюджетникам 
поцеловать: поцеловать 
васильича: Васильича 
марафон: марафон марафоне 
вычислить: вычислить 
чушь: чушь Чушь 
означать: означает означать 
далёкий: дальше Дальше 
освоить: освоить освоили 
набрать: набрали набрал 
судно: судов 
пррдукты: пррдукты 
реал: Реал 
правосудие: правосудия 
хватать: хватает хватало 
пятый: пятого пятые пятый 
омоложение: омоложение 
удовольствие: удовольствием удовольствие 
задница: заднице 
член: членам членом членов 
отбирать: отбирал отбирать 
кризисный: кризисные 
томас: Томасу Томаса Томас 
волга: Волга 
отказ: отказ отказа 
ядерный: ядерной 
осудить: осудит 
спасти: спас 
корея: Корея Корее 
экономика: экономике экономики 
нишевый: нишевый 
астрахань: Астрахань 
тёзка: тезка 
язык: языка язык языком 
запускать: Запускаем 
вести: ведя Ведем ведет вела 
проект: проекта Проект проект проектов проекты 
заявочный: заявочную 
брюссель: Брюссель 
претензия: претензий претензии 
орловский: Орловском 
образование: образованием образования образование 
вад: ВАДА Вада вада 
виталий: Виталию Виталий 
удачно: удачно 
коммерческий: коммерческий 
булла: Булл 
игрок: игроком игрока игрокам игрок игроками игроков Игроки Игрок игроку игроки 
шахматы: Шахматы 
корректировать: корректировал 
штангист: штангистов 
форум: форума форуме форумов 
ин: Ин 
лёгкий: Легкая легче легких 
захотеть: захотят захотели 
приказ: приказы приказ приказе 
многообразие: многообразии 
протон: Протон 
соревновательный: соревновательную 
вслух: вслух 
закрыть: закрыли закроет закрыл 
логинов: Логинов 
нагнуть: нагнут 
уважать: уважает уважаем уважают 
устроиться: устроиться 
расположиться: расположившись 
тезис: тезис 
фактор: факторами фактор факторы 
недавний: недавнюю недавнем 
подорожание: подорожанием 
больший: большую большая большего 
европейский: европейскими европейских европейская 
девочка: девочку девочки девочка 
грузия: Грузии Грузия Грузию Грузией 
захлопываться: захлопывается 
удача: удачу удачи Удача 
удивиться: удивлюсь удивятся 
ян: Ян 
рф: рф РФ 
мендонса: Мендонса 
восток: Востоку Востоке 
край: край края 
минздрав: Минздрав 
завершиться: завершится завершилась завершился Завершится 
шок: шоке шоком 
ценность: ценностями 
властитель: властителей 
аккредитация: Аккредитация аккредитации 
чей: чьим чьи 
май: мае мая 
дубль: дубль Дубль 
повысить: повышена повысить повысит 
гордо: гордо 
запредельный: запредельная 
подтверждать: подтверждаю подтверждали подтверждают 
воздух: воздухе воздуха воздухом воздух 
муха: мух 
охрана: охраны 
сыр: сыр 
выброс: выброс 
гандбол: Гандбол 
кипр: Кипр 
ресурс: ресурс ресурсы 
завод: заводах заводы заводам 
сей: сих 
идти: идете шедшие идет идите идти идущие иди идут Иду 
факельный: факельными 
ухин: Ухин 
талисман: талисманами 
упырь: упыри 
часть: частью Часть часть 
ребята: ребятам Ребят ребят 
альфа: Альфа 
молодой: молодых 
однако: однако Однако 
исправно: исправно 
алмаз: алмазы Алмаз 
зп: зп 
иранец: иранцы 
ажиотаж: ажиотажа 
согласовать: согласованном 
лёд: льду 
балтикфлора: Балтикфлора 
вечером: вечером Вечером 
экспертный: Экспертный экспертным 
новость: новости новостях Новость новостей Новости новость НОВОСТИ 
бразилия: Бразилии Бразилия Бразилией 
хм: хм Хм 
покинуть: покинул 
губернатор: губернатор губернатором Губернатор 
напомнить: Напомню напомним напомнила напомнить Напомним 
коллективный: коллективная коллективный 
кения: Кенией Кения 
парусный: Парусный 
честь: честь 
троицк: Троицке Троицк 
прогрессивный: прогрессивный 
нарушение: нарушения нарушении нарушений нарушением нарушение 
важно: важно 
произойти: произошло произойдет произошла произошедший 
негосударственный: негосударственными 
деменция: деменция 
звучать: звучит 
просто: Просто просто 
баланс: баланс 
преподноситься: преподносились 
сумма: сумме сумму 
зарплата: зарплату зарплата зарплат 
бесплатный: бесплатном Бесплатный 
предложить: предложил предложили 
автор: автора Автор 
удаление: удалении 
записать: записать 
гонка: гонок гонках гонку Гонка гонке 
сдохнуть: сдохнут 
странный: Странное странные 
соседний: соседних соседнюю 
нос: нос 
подавиться: подавится 
биатлонный: Биатлонный биатлонную 
подмосковный: подмосковные подмосковных подмосковном подмосковного 
комиссия: комиссии комиссию комиссия комиссий 
циркулярный: циркулярное 
предпринять: предпринять предпринято 
политик: политиков политик 
банкетный: Банкетный 
благодарность: благодарности 
строить: строит 
чтение: чтение 
объявлять: объявлять 
желание: желание желания 
здоровый: здоровая здоровым здоровому 
попрекать: попрекать попрекает 
прыгунья: Прыгунья прыгунье 
норильск: Норильска Норильске Норильск 
настрой: настроя 
наблюдение: наблюдением 
дешёвый: дешевле 
рычаг: рычаги рычаг 
реагировать: реагировать 
громко: громко 
концовка: концовке концовку 
бах: Баха Баху Бахом баху баха 
потихонечку: Потихонечку 
лыжа: лыжах лыж 
образ: образом образу 
удобный: удобней 
намного: намного 
держава: держава Державой державы держав 
отличие: отличие отличий 
нога: ноги ногой ногами 
спустя: спустя 
называть: называть называемым называемая называл 
наставник: Наставник 
предназначить: предназначенная 
восстановить: восстановили 
подопечный: подопечным Подопечные подопечные 
санкция: санкциями санкций санкциях 
буэнос: Буэнос 
фитнес: фитнес фитнеса 
уловить: уловили 
холодильник: холодильнике холодильника 
снежный: Снежные 
бегать: бегать Бегать 
святой: святые 
завраться: заврались 
служба: службу службы службе служба 
одиннадцатый: одиннадцатый 
сидеть: сидит сидишь сидят сидеть сидел сидите сидели 
никак: никак 
зона: зоны 
психология: психологию психологии 
поддержать: поддержали поддержу поддержать поддержал 
звезда: звезд звезды Звезды 
среда: среду среды 
оккупировать: оккупирует 
диван: диване 
выполнить: выполнит выполнят 
аргентина: Аргентины Аргентине Аргентину Аргентиной 
адресовывать: адресовывать 
основный: Основными 
приглашать: приглашает 
убивать: убиваете убивать убивают 
тягачёв: Тягачев 
посрать: посрать 
моисеев: Моисееву 
катить: катят 
дабл: дабл 
мобилизоваться: мобилизоваться 
использование: Использование 
использоваться: используется используются 
почётный: Почетный почетный 
ход: ходе ход 
знание: знанию знание 
феноменальный: феноменальную 
торжественный: торжественного 
продвигать: продвигать 
семь: семь 
предоставление: предоставления 
единство: единство 
зарабатыватьну: зарабатыватьну 
прогадать: прогадаем 
турция: Турцию Турция Турции Турцией 
прибыть: прибыла 
настольный: настольный Настольный 
интерес: интереса интересом интересами 
атлетика: атлетике атлетики атлетика 
поездка: поездки поездке 
толк: толка толку 
бо: Бо 
кто: Кому кем кому кого 
тёплый: теплых 
приглашение: приглашение приглашению 
дискриминационный: дискриминационные 
антидопинговый: антидопинговое антидопинговому антидопинговым Антидопинговому 
преследовательница: преследовательницы 
мультикамерная: мультикамерная 
раз: раза разу разы 
горсовет: горсовета 
состояться: состояться состоится состоятся состоялось 
балтия: балтии Балтии 
окошечко: Окошечко 
партнёрский: партнерские партнерских 
смиренно: смиренно 
база: базу базе баз базой 
конькобежный: конькобежному 
знакомый: знакомые знакомы 
обосрались: обосрались 
тягаться: Тягаться 
слеза: слезах слезы слеза 
минск: Минске Минск 
бежать: бегут бежали бежит бежать 
гораздо: гораздо Гораздо 
следить: следить следили следим 
договорённость: договоренностей 
диктатура: диктатура 
забанили: забанили 
бурятский: бурятскую 
граница: границу 
влияние: влияния 
лес: лес Лес 
факт: фактах факт факту 
прилететь: прилететь прилетел 
некий: неким некую некое 
ощущение: ощущение ощущений 
платить: платила платить платили платит платят 
гендиректор: Гендиректора 
фигуристка: Фигуристка 
задумываться: задумывалось 
спортсе: спортсе 
русски: русски 
март: марта марте 
фашист: фашистов 
удовлетворять: удовлетворяют 
догадываться: догадывались 
иной: иного иными 
задорнов: Задорнов 
преступление: преступления 
окончательно: окончательно 
любовь: любви 
долгий: долгое долгого Долгих 
вздохнуть: вздохнуть 
продюсер: продюсера 
бюджетирования: бюджетирования 
возглавить: возглавил возглавить возглавлю 
иль: Иль 
гора: гор 
подытожить: подытожил 
матыцын: Матыцын 
продавать: продает 
выгнать: выгнали 
съесть: съели 
инцидент: инцидент инциденте 
импровизировать: импровизировала 
соревноваться: соревнуются соревноваться соревновались соревнуясь 
декорация: декорация 
подготовка: подготовке подготовки Подготовка подготовку подготовка 
ошибаться: ошибались ошибаться 
сломать: сломанная 
рожать: рожают 
вывеска: вывеске вывеску 
ильдар: Ильдар 
кишечный: кишечной 
култаев: Култаев 
путь: путями путь 
выбор: выбора выбор выборе 
суверенитет: суверенитет суверенитета 
муслим: Муслим 
могилахот: могилахот 
коновый: Конова Конов 
неужели: Неужели неужели 
выдохнуть: выдохнуло выдохнули 
равняться: Равняюсь 
молоко: молока 
зайти: зайдет 
вес: весов 
буханова: Буханова 
июнь: июне июня 
хорватия: Хорватия Хорватией 
извинить: Извините извини извините 
конвенция: конвенцию 
норвежский: норвежских Норвежские 
призвать: призвало призвала призвал 
лагрейд: Лагрейд 
расход: расходы расходов 
одежда: одежде 
жеребец: жеребце 
латыпов: Латыпов 
убедиться: убедились 
легкоатлетический: легкоатлетический 
пряник: пряник 
никуда: никуда 
рассказывать: рассказывали рассказывает рассказывать 
стукнуть: стукнуть Стукнуть 
караук: караук 
аудитория: аудитории 
побыть: побыть 
последующий: последующего последующее 
уничтожить: уничтожили уничтожила 
финансы: финансов 
пресс: пресс 
тьфу: тьфу 
основание: основании оснований основаниях 
корочка: корочку 
кругом: кругом 
просить: просит Прошу просить 
некого: некому 
формат: формат форматы формате 
еврей: евреев 
радость: радости 
раздевалка: раздевалке раздевалку 
нахождение: нахождение 
противник: противников противник противником противника 
иа: ИА 
обнародовать: обнародовать 
убежать: убежала убежишь убежали 
площадка: площадок площадке площадка площадки площадку 
взаимный: взаимного взаимных взаимные 
самодостаточность: самодостаточность самодостаточностью 
жёсткий: жестким 
сионист: сионист 
очко: очко очков очка 
любимый: любимая любимую 
поставить: поставленные поставлено поставить поставили 
златоуст: Златоусте 
канибализм: канибализм 
эфир: Эфире эфиров эфире 
объединиться: объединилась 
невозможно: невозможно Невозможно 
переходить: переходят переходили 
проголосовать: проголосуют проголосовал проголосовать 
быстро: быстро 
перемена: перемен 
трансформация: трансформации 
финансовый: финансовым финансовая финансовые финансовых 
айдар: Айдарам 
хорошенько: хорошенько 
разработка: разработке разработку 
загадка: загадка 
последствие: последствиях последствия 
процесс: процесса 
внимание: внимания внимание 
спартакиада: Спартакиаде Спартакиаду Спартакиада 
техника: технику 
путать: путаете 
рассмотреть: рассмотрен рассмотреть 
хватить: хватит 
анатолий: Анатолий Анатолия 
подряд: подряд 
мила: Мила 
прикрепить: прикреплен 
удобно: Удобно удобно 
самостоятельность: самостоятельность 
плен: плену 
обзываться: обзывается 
космос: космосе космос 
ельцин: Ельцину Ельцина Ельциным 
политех: Политехом Политеха Политех 
левитин: Левитин 
врач: врачу врачи 
мишустин: Мишустин 
бороться: бороться борется борются 
разорвать: разорвало 
югра: Югру Югра Югре Югры 
зажить: заживут 
шарик: шариков 
польша: польше Польша 
жеребьёвка: Жеребьевка жеребьевки 
недостаточно: недостаточно 
оценить: Оцените оценил 
потратить: потратил 
свободный: свободнее свободного свободной свободным 
быстрый: быстрее 
фифа: ФИФА 
подобный: подобных подобную подобного Подобных подобное подобные 
адрес: адресу 
ограниченность: ограниченности 
система: система систему системы Системы 
изучение: изучения 
подчеркнуть: подчеркнул подчеркну 
ночью: ночью 
ппр: ППР 
промах: промахов промахах 
норильчанин: норильчан 
заполнить: заполнить 
сантэл: Сантэл 
комплектовать: комплектуют 
содержание: содержанию содержание 
раскрепоститься: раскрепостились 
отрабатывать: отрабатывает отрабатывать 
суверенный: суверенного 
госдума: Госдума Госдумы госдумой Госдуме 
частный: частных 
выплата: выплат 
беспокоиться: беспокоиться 
плохой: плохое хуже плохая 
карта: карта карту карты 
джонсон: Джонсоны 
награда: наград награды 
союзник: союзником союзников союзник 
наработать: наработать 
гостиница: гостиницы гостиница 
физрук: физруками 
коэффициент: коэффициенты коэффициентов 
пропагандолог: Пропагандолог 
увлекательный: увлекательная 
высказывание: высказывание 
прилипнуть: прилипнет 
переизбраться: переизбраться 
закрывать: Закрывала 
мол: мол 
базовый: базовой базовых 
тфу: Тфу 
отлучить: отлучить 
конституционный: конституционное 
хамасовцами: хамасовцами 
ближний: Ближнем 
поп: Поп попы 
моральный: моральных 
разговаривать: разговаривал 
давыдов: Давыдов 
психика: психику 
наступить: наступит 
стрельба: стрельбе Стрельба 
садик: садик 
носов: Носов 
урожай: урожай 
причинный: причинно 
находиться: находятся находился находящихся находится находиться 
шаг: шаг шаге 
уникально: уникально 
щедрый: щедрая 
ангарск: Ангарск 
чемпионка: чемпионка чемпионкой 
вдоль: вдоль 
замутить: замутите 
регулярно: регулярно 
валуев: Валуев 
взгляд: взглядов взгляд взгляды взгляда 
пункт: пункты пунктах пункта пунктам 
баня: баню 
очередной: очередные очередную очередная 
казаться: кажутся кажется казался казалось 
агрессия: агрессии 
любительский: любительского Любительский 
гжа: ГЖА 
убогий: убог 
связь: связь связи связей 
обвинить: обвинили обвинила 
господин: господину господин 
непрофессиональный: непрофессиональное 
пропагандист: пропагандистов 
назад: назад 
консервативный: консервативны консервативных 
категорично: категорично 
осуждать: осуждают 
портал: портал порталу портале 
благосклонность: благосклонность 
устойчивый: устойчиво устойчивая 
прийти: придут придет пришло 
колика: колик 
турецкий: турецких Турецкая турецкий турецкого турецком 
важный: важные важнейших важными важное важных 
пробирка: пробирках 
зайцев: Зайцева 
интересовать: интересует 
зики: Зики 
ехать: ехать едут ехали 
снова: снова 
родитель: родителям родители родителей 
закапывать: закапывают 
зеппа: Зеппа 
комментарий: комментариях комментария Комментарий комментарий 
смирнов: Смирнов 
вадим: Вадима 
достаточно: достаточно Достаточно 
соломатин: Соломатин 
потянуться: потянутся 
независимо: независимо 
леонид: Леонид 
относительно: относительно 
безумие: безумие 
качество: качествах качестве качество 
заявиться: заявиться заявится заявился Заявиться 
медиалиге: Медиалиге 
устраиваться: устраивался 
постельный: постельное 
закупился: закупился 
английски: английски 
дисциплина: дисциплинах дисциплины 
квалификация: Квалификация квалификации 
нужно: нужно 
мужество: мужество 
проив: проив 
бренд: бренд бренду 
нехороший: нехорошего 
принцип: принципам принципа принципом принципу принцип принципов Принципы принципе 
лозанна: Лозанну 
оргкомитет: оргкомитета оргкомитет 
денежка: денежки 
бан: бана бан 
дедушка: дедушки дедушку 
профессор: профессора 
вспоминаться: Вспоминается 
наизнанку: наизнанку 
предать: предать 
заканчиваться: заканчивается 
качественно: качественно 
осознавать: осознают 
дышать: дышать 
верить: верят верить верьте веришь верю Верил верил 
детальный: Детальный 
васильев: Васильев 
практика: практики практику практике 
выровнять: выровнять 
тройка: тройку тройке тройка 
профессия: профессиях 
феноменально: феноменально 
медийный: медийные 
орденноносец: Орденноносец 
банк: Банк банка Банка 
этнос: этнос этноса этносов 
унижение: унижение 
вновь: вновь 
международку: международку 
перейти: Перейдем перешедшие перешла 
формула: Формула 
приходить: Приходил приходят 
выбрать: выбраны выбрать Выберите выбрали 
пена: пена 
яйцо: яиц яйцами 
принимать: принимало принимающих принимают принимали принимает принимал принимать 
полбеды: полбеды 
жаль: жаль 
житель: жителям жителями жители 
паспорт: Паспорт паспорте паспорта паспортов паспорт паспортах 
татарстан: Татарстана Татарстан 
осваивать: осваивать 
исламистский: исламистское 
сковородка: сковородке 
реинтегрируемся: реинтегрируемся 
нищета: нищету 
объяснить: объяснили объяснить объяснит 
проходить: проходят проходили проходит проходить 
паралимпиады: Паралимпиады 
райзен: Райзен 
словения: Словения 
данный: данную данном 
фатх: ФАТХ 
внушить: внушили 
держать: держать держит 
рожков: Рожков 
колумбийский: колумбийский 
николай: Николай 
попрощаться: попрощались 
карьерный: карьерного 
андреасович: Андреасович 
горький: горькое 
сладкий: сладкий 
песков: Пескову Пескова 
ожидать: ожидаем ожидала ожидали 
пусть: пусть 
убыточный: убыточны 
уделить: уделить уделил 
пользовательский: Пользовательская пользовательские 
запрос: запрос запросов 
выдворить: выдворили 
снимать: снимают 
америка: Америка Америке 
источник: источников Источник 
начало: началом начале началах начала 
встреча: встреч Встреча встречи встрече встречу встречах встреча 
незаконный: незаконные 
социалку: социалку 
точно: Точно точно 
запугивать: запугивает 
рекордсмен: рекордсмен 
членство: членство 
дарить: дарить дарю 
дух: дух духе 
отчётность: отчетности 
запретить: запретить запретят запретил запретили запрещено 
дорабатывать: дорабатывать 
ездить: ездит ездили ездить 
смерть: смертью смерти 
сношение: сношениям 
явка: явкой явку 
поскольку: поскольку 
довольный: Доволен 
совместный: совместных Совместный совместный Совместными 
положение: положений положение положением 
получаться: получалась получается 
сложиться: сложилась сложилось сложившаяся сложившиеся 
железный: Железная железный 
помимо: помимо Помимо 
стремиться: стремятся стремиться 
боевой: боевой 
окно: окно 
почва: почве 
производственный: производственные 
пятница: пятница пятницам 
спасать: спасают 
эффективность: эффективность эффективностью 
уверить: уверены Уверена 
фристайлист: фристайлист 
скелетон: скелетон 
убрать: убрал убрать 
вчера: Вчера вчера 
клод: Клода 
натворить: натворить 
беспристрастность: беспристрастность 
разум: разум разуму 
документ: документы документ Документ документу документа документов 
привлечь: привлечет 
социалист: социалисты 
третий: третий третью 
говорящий: говорящая 
лететь: лететь 
анастасия: Анастасия 
институт: институт института 
цифровой: цифровых цифровую 
цифра: цифр 
постепенно: постепенно 
владыка: владыка 
воспользоваться: воспользовались 
мы: Нам нам нами 
мбаппе: Мбаппе 
последовательный: последовательные 
офис: Офис офис 
усилие: усилиями усилий усилия 
дружелюбно: дружелюбно 
требование: Требования требований 
рыба: рыбу 
обратиться: обратился Обратимся обратитесь обратиться 
существовать: существует существовал существуют 
сие: се 
убеждённый: Убежден убежден 
поздравление: поздравление поздравления 
прям: прям Прям 
марков: Марков 
беспредел: беспредела беспредел 
прелесть: прелесть 
отличиться: отличился 
цельный: цельным 
выгодно: выгодно 
ассоциация: Ассоциация ассоциация 
межконтинентальный: Межконтинентального 
грузинский: грузинский 
оригинальный: Оригинальный 
интеллектуальный: интеллектуальным 
трамплин: трамплина 
кампания: кампанию 
прошлый: прошлом 
грань: гранью 
выжить: выживут 
союз: союза союз Союзе союзом 
завтра: завтра 
вспомнить: вспомнить Вспомнить вспомнили Вспомните 
существенный: существенные 
ветка: ветке 
заодно: заодно 
постер: Постеры 
глубинный: Глубинный глубинное 
мужик: мужик мужиков мужики 
иран: Ирану Ираном Иране Ирана Иран 
станция: станция 
приводить: приводит приводить 
попрать: попрана 
сближать: сближают 
стоить: стоил Стою стоить 
реформа: реформ 
пельмешек: пельмешками 
поделать: поделать 
кулак: кулаком 
организованно: организованно 
столица: Столица столице 
шанхай: Шанхае 
попытка: попытка попытку попытке попытках 
резиновый: резиновых резиновая 
простой: простых проще 
слабоумие: слабоумия 
пьедестал: пьедестале пьедестала 
давление: давление давлением давлению Давление давления давлении 
пустота: пустоту 
инфаркт: инфарктов 
суд: Суд суде суд судах 
пометить: Пометить 
суббота: суббота субботу 
далее: далее 
ахинея: ахинею 
ключевой: ключевой ключевых 
колумбия: Колумбии 
идиотизм: идиотизма идиотизм 
локомотив: Локомотив Локомотива 
непризнание: непризнания 
посадить: посадили 
мяч: мячей мячом мяч мяча 
задавать: задавать задает 
отель: отеле 
нормализоваться: нормализовалось 
вырасти: вырастут 
привести: привести приведет привело 
соблюсти: соблюдены 
медик: медиков 
слабый: слабые 
фигурист: фигуристы фигуристов 
навек: навек 
маркус: Маркуса Маркус 
решать: решала решать решают решает 
впервой: впервой 
делиться: делиться делящиеся 
везде: везде 
инфраструктура: инфраструктуры 
чернышов: Чернышов 
подача: подачи подача 
область: области областей область 
письмо: письмо письмом 
яшин: Яшина 
глобальный: глобальными 
воздержаться: воздержаться 
поехать: поехать поеду поедут поедет 
бросить: брось бросят бросив бросить бросил 
толпа: толпы 
партнёр: Партнер партнера партнер партнеров 
бригадный: Бригадный бригадный 
одобрить: одобрите одобрило одобрил 
долгожданный: долгожданное 
фигня: Фигня 
медиалиги: Медиалиги 
завершение: завершении завершения 
включая: включая 
шорты: Шорт шорт шорты 
ручной: ручных ручного 
морг: морге 
канзас: Канзас 
федеральный: федерального 
приказать: приказали 
атака: атаке атаку атаки 
несостыковки: несостыковки 
либерал: либералов либерал 
настроить: настроенных 
сбрасывать: сбрасывать 
статус: статус статусе 
начальный: начальные 
финансирование: финансирования финансирование 
аль: Аль 
поедание: поеданию 
михаилович: Михайлович 
приоритет: приоритетом приоритет приоритете 
путём: путем Путем 
вектор: вектором 
развитой: развит 
скула: скулой 
амбиция: амбиции 
канивец: Канивец 
развивать: развивать развивают 
забывать: забываю забываете 
тянуть: тянуть 
спецпроект: Спецпроект 
передавать: передают 
выиграть: выиграла выиграет выиграть выиграл выиграют выиграли 
юдин: Юдин 
явно: явно 
экстрим: Экстрим 
оплата: оплаты 
скоровичу: Скоровичу 
авиастроение: авиастроении 
шайка: шайка 
эмиль: Эмиль 
узнавать: узнают узнавать 
скоровича: Скоровича 
пёс: пса псом 
слушание: Слушание 
править: правят 
арбитр: арбитр арбитров арбитра 
двукратный: Двукратный 
бесповоротно: бесповоротно 
ухта: Ухта Ухты 
контролировать: контролировали 
долг: долг 
точнее: точнее 
сергеев: Сергеев 
поредеть: поредеть 
рол: ролов 
израля: Израля 
обманывать: обманывал обманывай 
финансироваться: финансируется 
ринг: ринге 
дополнительно: дополнительно 
размер: размер размеру размеров 
ввести: ввести 
попытаться: попытались 
синхронный: синхронное синхронном синхронному 
планируютсядякую: планируютсядякую 
сербский: Сербского Сербский 
фильм: фильм фильма 
медицина: медицине медицину медицины медициной медицина 
натурализация: натурализация 
блог: блогу 
риск: рисков 
взаимодействие: взаимодействие взаимодействию 
виноградник: виноградники 
напоследок: напоследок 
догнать: догонит догнали 
мартин: Мартин 
семейный: семейные семейных 
ярмарка: ярмарки 
шымбергенов: Шымбергенов 
истинный: истинные истинном 
несмешной: Несмешные 
час: часа часов ЧАСА час 
приобрести: приобрело 
детский: детского детский 
загнобят: загнобят 
попадать: попадать 
детектив: детективах 
потерять: потеряли потерявшие потерял 
нервозность: нервозность 
аккредитациивот: аккредитациивот 
клон: клонов 
бразилец: бразильцев бразильцы бразилец 
грош: гроши 
обеспечивать: обеспечивают обеспечивает 
двадцать: двадцать 
бабушка: бабушки бабушку бабушка 
наготове: наготове 
комнатный: комнатные 
володя: Володя 
прок: прока 
небывалый: небывалом небывалое 
мандзын: Мандзын 
клетка: клетку 
вор: вор 
яркий: яркие яркая 
пирамида: пирамидами 
баскетболист: баскетболист 
нехрен: нехрен 
межведомственный: межведомственную межведомственная 
уверенно: уверенно 
халва: Халва 
маленький: меньше маленький маленьким Маленькому маленькая маленькое Меньше 
санкционный: санкционный 
прочь: прочь 
уткин: Уткин 
соглашение: соглашение 
шестнадцатиметровыми: шестнадцатиметровыми 
применять: применять 
кпрф: КПРФ 
грубость: грубость 
мастерство: мастерства мастерство 
танец: танцы 
пойти: пошла пойдет Пойдут пошел 
окончание: окончания 
нфл: НФЛ 
дюсши: дюсши 
продаваться: продаваться продаются продавалось 
ранее: Ранее ранее 
укр: укр 
кивать: кивать 
определиться: Определились определилась определились определиться Определись 
проблематика: проблематике 
цвет: цвет 
василий: Василий Василия 
двигаться: двигаться 
выбивать: выбивать 
галичанин: галичане 
умный: умнее умные 
проба: пробу пробах пробе 
фарт: фарта 
инструктаж: инструктаж 
урсула: Урсулы 
отозвать: отозвал отозвали 
причём: причем 
паралимпийский: Паралимпийскому 
гагарин: Гагарина 
футзальную: футзальную 
последовать: последовало 
селенкова: Селенкова 
тело: тела теле телу 
пятьдесят: пятьдесят 
рост: роста 
восстановление: восстановления 
тег: Теги 
масштаб: масштаб масштабы 
мечта: мечт 
муджахеды: муджахеды 
террорист: террористы 
приводиться: приводятся 
нечеловеческий: нечеловеческое 
уклад: укладе 
понести: понесло 
млрд: млрд 
русс: русс 
контакт: контакты 
оставаться: Оставаясь Оставалось Остается оставаться 
тур: туров тура туре 
забегаловка: забегаловок 
здравый: здравом 
бестолковке: бестолковке 
увольнение: увольнение 
хамство: хамство 
зависимость: зависимости зависимость 
городок: городков Городке 
станислав: Станислав Станислава 
приняться: принялись 
лепить: лепят 
двор: дворе дворах 
стартовать: стартует Стартует стартовал 
ложь: лжи 
сомнительно: Сомнительно 
значимость: значимости значимость 
лицензирование: лицензирование 
однажды: однажды 
вашингтон: Вашингтон 
становиться: становится становятся 
сперва: сперва 
бильярд: Бильярд 
постоялый: постоял 
генетический: генетическом 
немаловажный: немаловажный 
класс: классов 
ответ: Ответ ответ ответы 
конкурент: конкурента 
ввп: ВВП 
экономический: экономическое 
перетаскивать: перетаскивали 
полноценный: полноценных 
нестись: нестись 
скушать: скушал 
спонсор: спонсора спонсоры спонсором спонсоров спонсорами спонсор 
недостаток: недостатке 
трансформировать: трансформировать 
зелёный: зеленом 
родченков: Родченкову Родченков 
пломба: Пломба 
выдавливать: выдавливают 
риторический: риторический 
керзон: Керзона 
отоварить: отоварил 
записывать: записывать 
отзывчивость: Отзывчивость 
принести: Принесли принести принесли принесут 
питать: питаем 
ранний: раньше раннее 
отделять: отделяй 
светить: светит светят 
академия: академию 
дважды: дважды 
измениться: изменится изменилось 
грязный: грязных 
обычный: обычный обычные 
шумно: шумно 
прокомментировать: прокомментировал 
лагерь: Лагерь 
черлидирш: черлидирш 
сепарация: сепарация 
пхеньян: Пхеньян 
опасаться: опасаться 
миллиард: миллиарды 
доехать: доедут доехать 
профинансировать: профинансирует 
авангард: Авангарде 
хет: хет 
добиваться: добиваться 
миротворец: миротворцев 
бельгия: Бельгия 
подготовительный: подготовительные 
региональный: региональных региональным регионального 
возможно: Возможно возможно 
контрольный: контрольно 
газ: газ Газа 
офф: офф 
китай: Китаю Китай Китая 
перестать: перестал перестали перестала перестаньте 
ничья: ничью ничья 
страшно: страшно 
устареть: устарела 
обида: обиды 
предыдущий: предыдущих Предыдущие 
плевать: плевать 
выкупить: выкупил 
оружейный: оружейный 
лу: лу 
дно: дно дна 
реально: реально Реально 
вечер: вечера 
маскировать: маскирующие 
афанасьев: Афанасьеву Афанасьев 
возобновление: возобновления 
проход: проходе 
стадия: Стадия стадии 
разрешить: разрешит разрешенным разрешены разрешен разрешил 
забайкальский: Забайкальский 
возглавлять: возглавлявший возглавлял 
детство: детстве детства детство 
эстонский: эстонском 
алай: Алаев 
главред: Главредом 
встретить: встречен встретят 
мелочится: мелочится 
крупный: крупнейшие крупных крупная крупные крупнейший Крупнейший 
общаться: общались общается общаетесь 
килограмм: килограмм 
фхр: ФХР 
паркет: паркете 
плюнуть: плюнь 
совпадение: совпадение 
дума: дума думу Дума думе 
неплохой: неплохом неплохая 
трудный: трудное 
кристалл: Кристалл 
продолжить: продолжить продолжили 
демократический: демократическая 
законопроект: законопроекту законопроект законопроекта 
профукать: профукать 
схожий: схожих 
февраль: февраля феврале февраль 
отечество: отечество 
расправа: расправой 
игорь: Игоря Игорь 
столетний: Столетняя 
уфимец: уфимцы 
мэй: Мэй 
обосноваться: обосновались 
фнл: ФНЛ 
ветер: ветер 
фетисов: Фетисовым Фетисов 
перепутать: перепутал 
алкаш: алкашей 
изначальный: изначальную 
дисквалификация: Дисквалификация дисквалификация 
адаптироваться: адаптироваться 
набор: набором набор 
неловко: неловко 
туда: туда 
дотрагиваться: дотрагивался 
репетиция: репетиция 
неправильно: неправильно 
остальной: остальное Остальным Остальные остальным остальные остальном 
яма: яму 
заставить: заставьте 
намекать: намекает 
климент: Климент 
агентство: агентства агентству агентство 
зазеркалье: зазеркалье 
настать: настанет 
арена: арене арена Арене 
иллюзия: иллюзий 
плотно: плотно 
извиняться: извиняться 
путаный: путана 
продвинуть: продвинуть 
обстрел: обстрелах обстрелами 
вдова: вдовами 
новояз: новояза 
приличный: приличный 
вчерашний: вчерашний 
ассамблея: ассамблеи 
помощник: помощник Помощник 
привилегия: привилегия 
администрация: администрации 
спринт: спринт 
озвучить: озвучить озвучьте 
пыня: пыня 
подвергнуться: подвергся 
болгария: Болгария 
астраханец: Астраханцы 
помиловать: помилуйте 
псж: ПСЖ 
нажать: нажмите 
расследование: расследование расследования 
государствообразующий: Государствообразующие 
прекращение: прекращение 
анджелес: Анджелес 
осуществлять: осуществлять 
заключить: заключенным заключил 
олег: Олег 
полицейский: полицейский 
посев: посевов 
тина: Тина 
гнуть: гнуть 
замечать: замечает 
царить: царит 
фига: фигу 
положительный: положительный положительные положительному 
блеснуть: блеснуть 
ущемлять: ущемлять 
поколение: поколения поколение поколениях 
ретроградный: ретроградный 
зачастую: зачастую 
тихо: тихо 
фарерский: фарерские 
качать: качать 
давний: давний 
обращать: обращать 
инвентарь: инвентарь 
хоккейный: хоккейный 
бутбулем: Бутбулем 
отечественный: отечественного 
милован: Милованов 
несовместимый: несовместимые 
зря: Зря зря 
мальчик: мальчика мальчик 
потеря: потеря потерь 
централизованный: централизованная 
храбро: храбро 
раздробить: раздробленном 
полевой: полевые Полевые 
техникум: техникуме 
стараться: стараюсь стараться 
попросту: попросту 
заниматься: занимается занимались Занимаюсь занимаюсь заниматься занимающихся 
цинично: цинично 
мульта: мульта 
расширение: расширении 
продлевать: продлевать 
шарф: шарф 
задохнуться: задохнулся 
поздравить: поздравить 
даваться: дается 
генофонд: генофонд 
автоматически: автоматически 
реакция: реакция реакции реакцию 
павел: Павел 
модератор: модератором 
линия: линию 
вроде: вроде Вроде 
например: Например например 
полуфинал: полуфинала полуфиналов полуфинале полуфинал 
итоговый: Итоговая 
отсюда: отсюда 
репертуар: репертуаре 
качка: качками 
часто: часто Часто 
справка: справка 
заседание: заседании заседание 
предстоять: предстоит 
благосклонно: благосклонно 
публично: публично 
кстати: кстати Кстати 
сливаться: сливается 
вилисова: Вилисова 
подставлять: подставляет 
арсенал: Арсенала арсенале 
спартак: Спартаке Спартаку Спартака 
принципиальность: принципиальность 
медиафутбол: Медиафутбол 
любезный: любезный 
реинкарнируемся: реинкарнируемся 
виноватый: виноваты 
чудиться: чудится 
коалиция: коалиции 
мст: МСТ 
противоположно: противоположно 
белорус: белорусов белорусы 
феерически: феерически 
скользить: скользить 
столь: столь 
консервы: консервы 
учебник: учебникам учебники 
понсилуома: Понсилуома 
различный: различных различное 
дружелюбный: дружелюбные 
нормально: нормально 
некоторый: некоторым Некоторым 
учитель: учителей учителях учителя 
защитить: Защитит защитить 
наслаждаться: наслаждался 
ввиду: ввиду 
израильский: Израильское израильские израильский 
покорность: покорность 
герой: герой героев 
отслеживать: отслеживать 
напрямую: напрямую 
показывать: показывают показывает показывать 
стандартный: стандартных 
черногория: Черногория 
прибежать: прибежали 
планировать: планировал планируют 
западник: западникам западников западники 
хозяин: хозяев хозяевами 
никарс: Никарс 
ло: ло 
севастополь: Севастополем Севастополя 
боль: боль 
отделаться: отделалась 
пловчиха: пловчиха 
блогер: блогер Блогер 
прилетать: прилетаешь прилетает 
находить: находит находить 
марат: Марат 
нагнетать: нагнетать 
спрос: спроса спрос 
соображать: Соображают соображают 
норильский: Норильскому Норильский 
плести: плести 
аниматор: аниматорами 
игровой: игровая игровым 
расширять: расширять 
крым: Крымом Крыма Крым Крыму 
коротеев: Коротеев 
чайник: чайником 
арабский: арабских 
трата: трата 
вариант: вариант варианта варианты вариантами 
начальство: начальство начальства 
стимул: стимул 
стратегия: стратегию стратегия Стратегию 
бесконечный: бесконечные бесконечных бесконечном 
повелеть: повелят 
прокат: прокат 
недосягаемый: недосягаем 
страшный: страшную 
долго: долго 
впереди: впереди 
собачий: собачья 
безопасность: безопасности Безопасность безопасность 
ежедневно: ежедневно 
обрезать: обрезают 
пора: пора поры пор Пора 
тип: типа тип 
подставить: подставить 
проанализировать: проанализируют 
анализировать: анализировать 
привносить: привносить 
важность: важности 
символ: символ 
татьяна: Татьяна 
читать: читают Читайте читает 
егоров: Егоров 
психологически: Психологически 
тыс: тыс 
мма: мма 
креатура: креатурой 
теория: теории 
армия: армии армией 
коммуникация: коммуникациям 
двести: двухсот 
фм: ФМ 
пекинский: пекинская 
кэфы: кэфы 
военнослужащий: военнослужащих 
переставать: перестают 
избирать: избирает 
шубенков: Шубенков 
полететь: Полетите полетел 
страница: страница 
карякин: Карякин 
издеваться: издеваются издевается 
битва: битва Битве 
уступать: уступая 
поздно: поздно 
труба: трубы 
обувь: обувь 
служить: служить 
африканский: африканскими 
александр: Александр 
доказать: доказали доказав 
лч: ЛЧ 
ныне: ныне 
вынуждать: вынуждают 
безразличный: безразличен 
блокнот: блокнот 
официально: официально 
льготник: льготники 
нов: Нове 
поделиться: поделился поделилась 
плита: плита 
аннулировать: Аннулировать аннулировало 
немецкий: немецкому 
возникнуть: возникнет 
биатлонист: биатлонисты биатлонистов 
закономерно: закономерно 
выделяться: выделяются 
гуляев: Гуляев 
выдумывать: выдумывайте 
араб: арабов арабы 
саранск: Саранске Саранск 
пурген: пурген 
информировать: информируя 
крап: Крапе 
штука: штук 
непонаслышке: непонаслышке 
откопать: откопать 
переехать: переехал 
вытащить: вытащил вытащить 
полагать: полагаете 
турнирный: турнирной Турнирное 
омерзительный: омерзительная 
финансировать: финансировать Финансировать 
инсульт: инсульт 
прогрессировать: прогрессирует прогрессировать 
дебютировать: дебютирует 
бугор: бугром 
достать: достал достать 
побороться: побороться поборитесь 
просрочить: просроченные 
забор: забором забор 
зрение: зрения 
построить: построена построенную построить 
скрывать: скрывала скрывать 
пожимать: пожимать 
автономный: Автономного 
питер: Питере Питер 
кушать: кушай 
изменить: изменить 
рпл: РПЛ рпл 
бешеный: бешеным 
увлечься: увлекся 
поклон: поклон 
осуществиться: осуществится 
финалист: финалистом 
опасный: опаснее 
подлинный: подлинного подлинное 
нафиг: нафиг 
октагоне: октагоне 
попасть: попасть попаду попал попала 
стыд: стыда 
совместно: совместно 
велоспорт: Велоспорт 
распустить: распустить 
ифк: ифк 
доживать: доживает 
цикл: цикла 
пантомима: пантомиму 
гребля: Гребля 
генеральный: Генеральный генерального генеральным генеральный 
вырвать: вырвали 
прокатывать: прокатывало прокатывает 
гаванист: гаванист 
поднимать: поднимает 
затем: затем 
конституция: конституция Конституции 
приветствие: приветствия 
страдать: страдают страдает 
пекин: Пекин Пекине 
даниса: Данис 
знатно: Знатно 
память: памяти 
порвать: порвала 
инфы: инфы 
подумать: подумала подумать подумали подумал 
вероника: Вероника 
целое: целом 
дура: дура 
упрёк: упрек 
кадровый: кадрового 
впадать: впадать 
дюша: Дюша 
каеда: Каеда 
ловить: ловили 
добраться: добралась 
докладчик: докладчика 
метод: методов 
сезон: сезонов сезоне сезона сезон 
кой: кое 
трасса: трассу 
столкнуться: столкнулась 
подбор: подбором 
паралимпиад: Паралимпиад 
каннабиноидов: каннабиноидов 
фану: фану 
ультиматум: ультиматум 
взаимопонимание: взаимопонимания 
констатировать: констатировать 
патриотизм: патриотизм 
футзальная: футзальная 
неоднократно: неоднократно 
таджикистан: Таджикистан 
конечный: конечном 
материал: Материалы 
успокаивать: успокаивать 
ютуб: ютуб 
дело: делу дела дело деле дел делом 
около: ок 
буржуазный: буржуазные 
бидон: бидон 
прожект: прожектов 
пул: Пуле пул Пула 
вязаться: вяжется 
чше: чше 
симон: Симон 
выделять: выделять выделяло 
подстроиться: подстроиться 
эскорт: эскорт 
отталкиваться: отталкиваться 
лично: лично 
окрепнуть: окреп 
мера: мер мере меру 
общение: общение общения 
нац: нац 
недопуске: недопуске 
жена: жен женой 
вериться: верится 
одеяло: одеяло 
городской: городской 
надоесть: Надоели 
надой: надоев 
гармоничный: гармоничное 
похищение: похищение 
уникальный: уникальную уникальная уникальных 
закрытый: закрыты 
жестокость: жестокости 
бросание: бросания 
чр: ЧР 
эдуард: Эдуард 
желать: желаете Желаю желаю желает желающих 
пожелать: пожелаем 
завуалировать: завуалировано 
полезный: полезным 
неотъемлемый: неотъемлемыми 
медаль: медалей медаль медалями 
помнить: помнит помним Помню 
дотация: дотациях 
насколько: насколько 
правильный: правильным правильные правильный 
дистанция: дистанций дистанцию дистанции 
общероссийский: общероссийских 
смириться: смиритесь смирились 
взбодриться: взбодрилась 
корейский: корейскую 
статистически: статистически 
вьетнам: Вьетнамом 
дополнительный: дополнительной 
умар: Умар 
направить: направленных направить 
олюнин: Олюнин 
резко: резко 
конкурировать: конкурировать 
десятый: десятый 
байкал: Байкала Байкал 
способность: способность 
конкурс: конкурс 
кормушка: кормушка 
рота: роты 
логичный: логичное 
говориться: говориться говорится 
взывать: взывать 
мёртвый: мертв 
тариф: Тарифы 
шумок: шумок 
чесание: чесании 
потенциально: Потенциально 
санкт: Санкт 
некуда: некуда 
карман: карману кармане 
понятно: понятно 
просмотр: просмотра 
показуха: показуха 
литовский: литовским 
гимнастика: Гимнастика гимнастика гимнастике 
сесть: Сядем сесть 
подарок: подарки 
расширить: расширить 
вызов: вызов 
бригада: бригаду 
пятидневный: пятидневной 
дискриминировать: дискриминируемый 
мозг: мозгов мозг мозгом 
финишный: финишную финишном 
стебутся: стебутся 
минспорттуризмом: Минспорттуризмом 
наслать: нашли 
коммент: комменты 
хамить: хамить 
собрание: собрание 
данные: данных 
настучать: настучать 
зафиксировать: зафиксирована зафиксировано зафиксировало 
взрослый: взрослых 
оскорбительный: оскорбительное 
точный: точному Точное точная 
род: рода 
доза: дозы 
поддержка: поддержки поддержке поддержка поддержку 
отдельно: отдельно 
фк: ФК 
налогообложение: налогообложения 
дерево: Деревья 
укрепление: укрепление 
засунуть: засунул 
бегун: бегунами 
следствие: следствие следствием 
братство: братства братство 
очиститься: очиститься 
присоединять: присоединять 
мораторий: мораторий 
лара: Лара 
дискриминация: дискриминацией дискриминацию дискриминации дискриминация Дискриминация 
синхронисток: синхронисток 
подразделение: подразделение 
комната: комнате 
пересидеть: пересидел 
урал: Урал 
поблагодарить: поблагодарить 
ужинать: ужинает 
понятный: понятней понятен 
безнадёжный: безнадежные 
побежать: побегут 
максимум: максимуму максимум 
вышка: вышек вышки 
вызывать: вызывал 
газа: Газу Газы 
завоёвывать: завоевывать 
экспресс: Экспресс 
православие: православие 
наказать: наказан Наказать 
блаттер: Блаттера 
красота: красота 
юлия: Юлия 
три: трех 
казанский: казанское 
колесников: Колесников 
вкурсе: вкурсе 
музыкальный: Музыкальное 
разногласие: разногласий 
иркутский: Иркутская 
олейник: Олейника 
попирать: попирает 
оказаться: оказался оказалось 
парень: парни 
ибн: ибн 
тренироваться: тренировались тренируются тренироваться 
форзяр: Форзяр 
заезжать: заезжала 
гипс: гипс 
лицемерный: лицемерное Лицемерный 
сложить: сложа 
ицхак: Ицхак 
штучка: штучки 
несчастный: несчастные 
премьер: Премьер премьер 
подбираться: подбираемся 
случиться: случилось случится 
экзотический: Экзотические 
неизвестный: неизвестного 
поспарринговаться: поспарринговаться 
армения: Арменией Армения 
закусить: закусить 
афганистан: Афганистан 
неумный: неумными 
слюна: слюной 
впервые: впервые Впервые 
массовый: массового массовой 
гук: Гук 
ненужный: ненужными ненужные 
понравиться: понравится 
вводить: вводя 
вл: ВЛ 
латвиец: латвийцы 
заведение: заведение 
стрелковый: стрелковом 
блат: Блатов 
тасоев: Тасоев 
искусственно: искусственно 
поражение: поражение поражения 
повышать: повышать повышая 
толчок: толчок 
воздействие: воздействия 
фшм: ФШМ 
шведский: шведская 
ожидание: ожиданиями 
поворот: поворот 
неудобно: неудобно 
млн: млн 
оперативный: оперативные 
нечаянно: нечаянно 
заманить: заманить 
настолько: настолько 
расписать: расписать 
девятый: девятый 
прибалтика: Прибалтике 
елецкий: елецкий 
гнушаться: гнушался 
демократия: демократия демократии 
ростов: Ростова 
иронизировать: иронизирует 
саратовский: саратовском саратовская 
признак: признаки признак признаку признака 
молодёжный: молодежная молодежной 
афальте: афальте 
привилегированный: привилегированные 
листунова: Листунова 
магнуссен: Магнуссен 
перевернуться: перевернулись 
разумный: разумное 
предлагаться: предлагаются 
головин: Головина 
алексвывод: Алексвывод 
версия: версия 
наверно: Наверно наверно 
период: период 
предатель: предатель предателей 
вова: Вова 
домой: домой Домой 
сатурн: Сатурн 
вкусный: вкусный 
гаджиев: Гаджиев 
минимум: минимум Минимум 
щедро: щедро 
провести: провел провела проведут проведет провести провели 
свора: свору 
додумывать: Додумывайте 
кухня: кухне 
проецировать: проецируем 
маркин: Маркин 
сентябрь: сентября сентябре 
мероприятие: мероприятиях мероприятий мероприятии 
отклонить: отклонил 
алексей: Алексею Алексей 
раздрай: раздрай 
транспорт: транспорт 
обстановка: обстановка обстановки 
легкова: Легкова 
мириться: мириться 
решительность: решительность 
путриотическую: Путриотическую 
мудрый: мудром 
общечеловеческий: общечеловеческими 
единение: единения единение 
стайер: стайеры 
проводник: проводниками 
инициатива: инициативе инициативу 
прохлаждаться: прохлаждается 
наглядно: наглядно 
многое: многое многом 
вузовский: вузовские 
скидываться: скидывались 
потрудиться: потрудиться 
сейм: сейме Сейм Сейма 
сталин: Сталину Сталина 
боксёр: боксерами боксером боксер 
штаны: штанах 
куба: Куба 
нанять: наняли 
предводитель: предводителя 
прибывать: прибывать 
существенно: существенно 
дорого: дорого 
алжирский: алжирский 
англосакс: англосаксов 
граф: Граф 
чудо: Чудес чудеса 
попов: Попов 
лейка: лейка 
практически: Практически практически 
виктория: Виктория 
похвально: Похвально 
стабильность: Стабильность стабильность 
алёшин: Алешин 
регрессировать: регрессировать 
патрон: патронов 
профессионал: профессионалов 
модератором: модераторома 
кишка: кишка 
кудисова: Кудисова 
денисов: Денисов 
валиев: Валиеву 
отмазать: отмазать 
безумец: безумец 
затащить: затащить 
зарегался: зарегался 
грозный: Грозный 
терюшков: Терюшков 
горный: горного 
прошлогодний: прошлогоднюю 
красный: красно красную 
основать: основано 
выявление: выявлении 
доверять: доверять 
тонкий: тонка 
расходиться: расходятся 
прдаются: прдаются 
ошибка: ошибка ошибок ошибке 
выполнять: выполняют выполнять 
выкладывать: выкладывали 
начинать: начинает начинать Начиная начинаешь 
поправить: поправить 
возрождение: возрождении 
дисциплинарный: дисциплинарное дисциплинарном 
портить: портите 
генерал: генерал 
упомянуть: упомянутого 
драка: драка 
отмечаться: Отмечается 
административный: административного административным 
рывок: рывках рывок 
отразить: отразило 
затронуть: затронул 
прибамбас: прибамбасов 
изрядный: изрядные 
харламов: Харламов 
убедить: убедить убедил 
мусульмаен: мусульмаен 
беречь: берегут 
митин: Митин 
матицын: Матицын 
население: населения население 
групповой: группового групповом 
сообщение: сообщении сообщение 
заплатить: заплатили заплатит 
нелепый: нелепы 
равно: Равно равно 
оттачивать: оттачивает 
обидно: Обидно обидно 
грузчик: грузчиком 
код: код 
капля: капли 
отсталость: отсталость 
придумывать: придумывала 
аргентинский: аргентинская 
игнорировать: игнорирует 
энный: энное 
бог: Богу БОГА 
трудиться: трудясь 
ком: комом 
насилие: насилию 
гражданство: гражданство гражданства 
уфа: Уфа 
возражение: возражений 
десятка: десятку 
насыпать: насыпать 
продержать: продержит 
независимый: независимое независимыми 
спортинга: Спортинга 
раненый: ранеными 
отдавать: отдают 
восприниматься: воспринимаются 
лицемерие: Лицемерие лицемерие 
делие: Делие 
сердечно: сердечно 
пообщаться: пообщаться 
лицемер: лицемер 
кг: кг 
ишкова: Ишкова 
пробиться: пробилась 
двадцатый: двадцатые 
прошлое: прошлое прошлого прошлым 
инновационный: инновационные 
корова: коров 
сочинять: сочиняя 
ускакать: ускакала 
космический: космической космические 
благодаря: благодаря Благодаря 
челябинск: Челябинске 
контроль: контролем контроля контроль 
улететь: улетели улетит 
завидный: завидно 
микишкова: Микишкова 
айрес: Айресе 
фактически: фактически 
предостеречь: предостерег 
чушпан: чушпан 
шар: шар 
подрастать: подрастающее подрастающего подрастают 
судак: судака 
пауза: пауза паузы 
всякий: всякие всяких 
приложить: приложил приложит 
пальма: Пальмой 
порой: порой 
выносливость: выносливости 
спортингом: Спортингом 
якут: Якуту 
многий: Многим многими 
китайский: Китайский 
сергачев: Сергачев 
бюджет: бюджет бюджете бюджета 
напринимать: напринимали 
адам: Адам 
встречаться: встречаться встречались 
грамотно: грамотно 
заключаться: заключается 
ментальный: ментально 
кристиансена: Кристиансена 
посещать: посещаемая 
насонов: Насонов 
фан: Фан фан 
анна: Анна 
моментально: моментально 
состояние: состояния состоянии 
диссидент: диссидентами 
раунд: раунда раунде раунд 
роо: РОО 
хуа: Хуа 
истекать: истекает 
сначала: сначала 
наверняка: наверняка 
ликвидировать: ликвидировать 
королевство: Королевство 
прозрачный: прозрачен 
замгенпродюсера: Замгенпродюсера 
электричка: электричке 
тренировать: тренирует тренировать 
дмитрий: Дмитрия Дмитрием Дмитрий 
пенсионный: пенсионного пенсионный 
ответственный: ответственный 
эль: эль 
аспект: аспектов 
развалиться: развалились развалится 
опозориться: опозорились опозориться 
календарь: календарь 
цифровизацию: цифровизацию 
сибирь: Сибирь Сибири 
определение: определению 
допускать: допускать допускающие допускали 
братишка: братишка 
ромуло: Ромуло 
сектор: сектору секторе 
деформация: деформация 
перепить: перепил 
неизбежно: неизбежно 
выстрел: выстрел 
комментатор: комментаторов комментаторами 
освещаться: освещается 
средний: Средней средней средний 
трактоваться: трактуется 
айди: айди 
объяснять: объясняет 
о: обо 
волк: волки 
художественный: художественная 
крылов: Крылова 
честно: честно 
зритель: зрителей 
адекватный: адекватных 
лишиться: лишились 
менеджер: менеджер 
напасть: напали напал 
самостоятельный: самостоятельными 
исследование: исследование 
неблагодарный: неблагодарный 
удивление: удивление 
венесуэла: Венесуэла 
мирный: мирными 
башня: башни 
модный: модное 
талантливый: талантливейшие талантливая 
греция: Грецию 
накануне: накануне Накануне 
простыня: простыня 
счастливый: счастлив счастливое 
перелёт: перелеты 
счастие: счастье 
капиталистический: капиталистические 
интриган: интригана 
киноиндустрия: киноиндустрии 
каша: кашу 
вперёд: вперед 
петербург: Петербурга Петербурге Петербург 
эстафета: эстафетах 
универсальный: универсального Универсальная универсальная универсальные 
отрезвлять: Отрезвляет 
разбираться: разбираться 
убегать: убегать 
казахстанский: казахстанский Казахстанские 
сочинить: сочинивший 
заслуживать: заслуживает 
эмоция: эмоциях 
обама: Обаму 
поддаться: поддаться поддались 
занзибар: занзибары Занзибар 
скорее: скорее 
упорный: упорном упорные 
реализоваться: реализуются 
употреблять: употреблять 
дурачок: дурачка 
задание: заданием 
ссср: СССР 
книга: книги 
тихонов: Тихонов Тихонова 
момент: момент моменты момента моментов моментами 
многочисленный: многочисленную многочисленных 
это: этим 
жирный: жирного жирные 
банкет: банкет 
давно: давно Давно 
запарадил: запарадил 
ностальгия: ностальгия 
хер: хер 
пускать: пускают 
составить: составить 
жалоба: жалобой жалобу 
шлем: шлема 
стреляться: стрелялось 
личный: личная 
мотивированный: мотивированно 
домашний: домашний домашних 
бандитский: бандитских 
сквер: скверах 
йота: йоту 
валить: валить 
позиция: позиция позициях позицию 
чисто: Чисто чисто 
денонсировать: денонсирующие денонсировала 
применяться: применяются 
салат: Салата 
изобретательно: изобретательно 
глупость: глупость 
возбудить: возбуждено 
туповатый: туповат 
распространяться: распространяется 
обмен: обменов 
семья: семьями семью 
современник: современников 
ненормально: ненормально 
успешный: успешный 
семён: Семен 
тотальный: тотальную 
ремонт: ремонт 
необходимо: необходимо Необходимо 
съехать: съехали 
отлично: отлично 
щи: щам 
отнять: отнял отняло 
подтвердиться: подтвердились 
группировка: группировок 
дача: даче 
юбилейный: Юбилейному 
сессия: сессию 
уральский: уральские 
выставлять: выставляет 
чай: чай 
пакет: пакет 
накопить: Накопленный 
задать: зададут 
площадь: площадь площади площадью 
цивилизация: цивилизация 
ирак: Ирак 
дойти: дошло дошли 
котлета: котлет 
поступок: поступками 
фсо: ФСО 
роды: родов 
гаджимагомедов: Гаджимагомедовым 
нацизм: нацизм нацизме Нацизм 
текила: Текила Текиле 
зеркало: зеркал 
развеваться: развеваться 
приблизиться: приблизиться 
проявлять: проявляет проявлять 
сразу: сразу 
запеть: запел 
пояс: пояса 
ворота: ворот ворота воротам 
элита: элит 
указание: указаний 
транзит: Транзиту Транзит 
вывод: выводы 
организм: организм 
палмейрасу: Палмейрасу 
суперкубок: Суперкубке 
изнутри: изнутри 
постоянный: постоянных 
фронт: фронт фронта 
внедрить: внедрил 
обилие: обилие 
собраться: собрались собралась собраться 
ощущать: ощущаю 
напротив: напротив 
чрезвычайно: чрезвычайно 
оба: Обе обе обоих 
бюджетный: бюджетных 
освобождение: освобождения 
посидеть: Посидели 
беттмэн: Беттмэн 
соц: соц 
подразнить: подразнить 
перестрелять: перестрелять 
ирина: Ирина 
открытый: открытую 
ата: Ате 
ценитель: ценителей 
полчаса: полчаса 
юношеский: юношеских Юношеская 
пристрастно: пристрастно 
замыкать: замыкают 
печерск: печерск 
нереально: нереально 
бес: бесе 
ген: Гена 
блок: блока блоком 
философия: философии 
слобожанщина: слобожанщина 
длинный: длинная 
ки: КИ 
оклад: Оклад 
галицкий: Галицкому 
десять: десяти 
канада: Канада 
авторитет: авторитет 
позвать: позвали 
многократно: многократно 
окраска: окраску 
градусник: градуснике 
логично: Логично 
отбить: отбита 
общественный: общественный общественная общественных 
поменять: поменять 
массово: Массово 
выстоять: Выстояли 
труд: трудов трудом 
серёга: Серега 
район: района 
халявный: халявные 
купить: купил 
модель: моделей моделями 
благодарный: благодарен Благодарен 
придержать: придержали 
солнце: Солнце солнца 
местечко: местечка 
письмецо: письмецо 
вахромичеввчера: Вахромичеввчера 
сын: сын Сын сыновья 
срок: срока Срок сроком срок 
профиль: профиле 
сто: ста 
контратака: контратаках контратак 
вячеслав: Вячеслав 
этадругое: ЭТАДРУГОЕ 
научиться: научились 
доверие: доверие 
показ: показ 
пожалуйста: пожалуйста 
поить: поят 
подушка: подушку подушка 
имайчева: Имайчева 
радоваться: радуются 
создание: создании создание 
выписать: выпишет 
спокойный: спокойна 
трижды: трижды 
фзк: ФЗК 
новосибирск: Новосибирск Новосибирска 
обстрелять: обстрелял 
неформальный: неформальный 
юркин: Юркин 
трещена: трещена 
камбэк: камбэк 
чуткий: чуток 
аудит: аудит 
подвал: подвалах 
ситниковый: Ситников 
команднике: команднике 
неожиданно: Неожиданно 
неконструктивный: неконструктивную 
подземельный: подземельное 
кайрат: Кайрат Кайрата 
слушать: слушать 
они: ними 
потенциал: потенциала потенциал 
баллон: баллоны 
ущерб: Ущерб 
убийство: убийству 
абдул: Абдулов 
чухрий: Чухрий 
понт: понтов 
гражданский: гражданское 
кратце: кратце 
вероятно: вероятно 
балобол: балобол 
лепоарды: лепоарды 
рамка: рамках рамки 
клиент: клиенту клиент 
синара: Синары Синара Синару 
жарко: жарко 
эпизод: эпизодов эпизоды 
недооценивать: недооценивать 
хух: Хух 
танцевать: танцует 
панорама: Панорама 
подвозить: Подвозите 
заклинание: заклинание 
поднять: Поднял поднять поднимет 
запланировать: запланированы 
документаха: документаха 
нарастить: нарастили 
патриотический: патриотическими патриотического 
проигрывать: проигрывал проигрывали проигрывает 
мастер: мастер 
поплясать: попляшет 
фонд: фонд 
оздоровление: оздоровления 
упрекать: упрекать 
авеланж: Авеланж 
швеция: Швеции 
утонуть: утонешь 
обострение: обострения 
израйля: Израйля 
громов: Громов 
иммунитет: иммунитет 
нижний: Нижнего Нижний 
второразрядник: второразрядник 
континент: континентов 
дискрименацией: дискрименацией 
выходной: выходные 
строй: строя 
демагогия: демагогия 
км: км 
поздняков: Поздняков 
исполком: исполкома 
переизбратся: переизбратся 
вместо: вместо Вместо 
закрепление: закрепления 
поезд: поезд 
заявлять: заявляет 
заход: заход 
огорчить: огорчен 
пробный: пробный 
очки: очках очками 
актив: активе 
разочаровать: разочарован 
кататься: кататься 
патриарх: патриарха 
хроника: хроники 
срыв: срыва 
прыгнуть: прыгнул 
алёшка: Алешка 
нуль: нуля 
влезть: влезут 
дерзкий: дерзкие 
нейтралитет: нейтралитету 
умирать: умирал 
атрибут: атрибутом 
совещание: совещании совещаниях совещания 
понадобиться: понадобятся 
секуляристам: секуляристам 
бестолковый: бестолковая 
григорий: Григорий 
змс: ЗМС 
сообща: сообща 
сведение: сведений 
фол: фолы фолов 
укрепить: укрепила 
мой: мои мое моих 
ватиканский: ватиканские 
раскритиковать: раскритиковал 
сорокин: Сорокин 
маньчжурия: Маньчжурия 
освобождать: освобождай 
негр: негром 
девятка: Девяток 
крокус: Крокус 
белоруссия: Белоруссии Белоруссией Белоруссия 
переименование: переименования 
стремление: стремление 
награждение: награждение награждении 
госуслуга: госуслугами 
классик: Классик 
молдова: Молдовы Молдовой 
каннабиноид: каннабиноид 
твёрдость: твердость 
тактика: тактики тактику 
алга: АЛГА 
малинин: Малинин 
оон: ООН 
малика: Малика 
гавайи: Гавайях 
тд: тд 
вассал: Вассалы 
поэтому: поэтому Поэтому 
устав: уставом 
разговор: разговоры разговоре 
ленин: Ленина 
многонациональный: многонациональном 
привыкать: привыкать 
урезать: урезать 
добрый: добры 
шиномонтажку: шиномонтажку 
обнаружить: обнаружен 
саркастичный: Саркастичный 
мозоль: мозолей 
позавидовать: позавидуешь 
жест: жестами 
частый: чаще 
корреспондент: корреспонденту корреспондентом корреспондент 
соцсеть: соцсети соцсетях 
передача: передаче 
зеленов: Зеленов 
гаванизма: гаванизма 
устанавливать: Устанавливать 
разрабатывать: Разрабатываем 
неверно: неверно 
абсурдный: абсурдными 
портрет: портретами 
мирнинцы: мирнинцы 
всеоружие: всеоружии 
гениальный: гениальный 
безумный: безумнее 
напрячься: напряжется 
акушерка: акушеркой 
прежде: прежде 
демонстрировать: демонстрировать демонстрирует 
регистрация: регистрация 
середина: середине 
анонс: Анонс 
лкс: ЛКС 
владислав: Владислав 
трамп: Трампу 
немного: немного 
сыктывкарский: сыктывкарскую 
краса: красе 
сахар: сахара 
планк: Планка 
оказание: оказание 
далеко: далеко 
расстройство: расстройство 
крыло: Крылья крылом 
обурить: обурили 
покер: Покер 
надуть: Надули надули 
тюрьма: тюрьмах 
подработка: подработку 
карточка: карточку 
волейбол: Волейбол волейбол волейболу 
почитать: почитал 
традиционный: традиционные традиционном 
сутки: сутки 
кхе: кхе 
асад: Асадов 
старший: старше 
дружеский: дружеские 
напёрсточник: наперсточники 
примерно: Примерно примерно 
завершить: Завершил завершена 
ветеран: ветеранов 
фаворит: Фаворит фаворитов фаворите 
течение: течение 
налогоплательщик: налогоплательщиков 
марк: Марк 
запорожье: Запорожье 
формально: формально 
взрывать: взрывать 
розыгрыш: розыгрыша 
свищева: Свищева 
числиться: числится 
таблица: таблице таблица 
навка: Навка 
маршрут: маршрута 
никитинда: Никитинда 
обязательно: Обязательно обязательно 
спич: спиче 
девушка: девушку 
каток: катков 
мелочь: Мелочей 
ои: ОИ 
уйма: уйму 
курятина: курятину 
оперативно: оперативно 
стартовый: стартов стартового 
мужчина: мужчин мужчины 
обратить: обратили 
вполне: вполне 
металл: металлом 
бадминтон: Бадминтон 
тройник: тройников 
двухтысяча: двухтысяча 
фекс: фекс 
людоед: людоедов 
верный: вернее верного верное 
шизофрения: Шизофрения 
отправка: отправку 
школьница: школьницы 
вернуться: вернуться вернулись вернулась 
масштабный: масштабные масштабный 
ненавидеть: ненавидят ненавидеть 
правильно: Правильно правильно 
занимать: занимают занимает занимали 
заплыв: заплыва 
мельник: Мельник 
рассол: рассол 
крепкий: крепче крепкая 
доставить: доставить 
фрагментировать: фрагментирует 
совместительство: совместительству 
грандиозный: грандиозное 
надрессировать: надрессировали 
имущество: имущество 
умение: умению 
нацизмвы: нацизмвы 
влиять: влияет 
пилорама: пилораму 
оттенок: оттенком 
творить: творили 
закончиться: закончился закончилась закончится 
развал: развала 
жрать: жрать 
также: Также также 
барселона: Барселона Барселоной Барселоне 
георгий: Георгий 
высшку: высшку 
вар: ВАР 
событие: событие 
возрастать: возрастают 
покрасоваться: Покрасоваться 
заткнуться: заткнутся 
вадавцам: вадавцам 
дзюбе: Дзюбе 
состоять: состоит 
исход: исход 
терапевтический: терапевтические 
переговоры: переговоры 
потребность: потребность 
верон: Верон 
враждебно: враждебно 
учёба: учебу 
ттд: ТТД 
макдональдс: Макдональдс 
пока: пока Пока 
приятно: приятно 
замечательный: замечательно 
игил: ИГИЛ 
герцеговина: Герцеговина 
молодёжь: молодежи молодежью молодежь 
яблоков: Яблоков 
очиститель: очиститель 
выписывать: выписывать 
деградация: Деградация 
наоборот: наоборот 
латвия: Латвия 
порог: пороге 
главком: главкомом 
второстепенный: второстепенный 
буш: Буше 
оплатить: оплатить 
очередь: очередь 
афган: Афган 
фильтровать: фильтровать 
опера: оперы 
расстёгивание: расстегивание 
расстроить: расстроен 
жанр: жанра 
заза: Заза 
немыслимый: немыслим немыслимые 
москвич: москвичей Москвичи 
терпеть: терпит 
мода: Мода 
поздний: позже 
тепло: тепло 
товар: товаров 
ростислав: Ростислав 
звать: зовем 
предполагать: предполагали предполагает 
меморандум: меморандум 
социализм: Социализм 
стул: стулом 
толстый: толстый 
аляска: Аляску 
голос: голос 
оказать: оказать 
допинговый: допинговые 
цель: цель Целью 
понад: понад 
конёк: коньки Коньки 
перевод: перевод 
робинью: Робинью 
прогресс: прогрессу прогресс Прогресс 
узкий: узком 
география: географию 
опоздать: опоздать 
ленинградский: Ленинградской 
аншлюс: аншлюс 
я: мной 
против: против Против 
структура: структуре структуру 
подписывать: подписывать 
отыграть: отыграют 
клевета: клевету 
позволять: позволяло позволяют 
форвард: Форвард форварда 
очень: Очень очень 
праздник: праздником праздник 
бесконечность: бесконечность 
гулять: гулять 
аквариум: Аквариум 
япония: Япония 
анал: анала 
вытирать: вытирают 
воспитать: воспитать воспитавшие 
пахать: пашут 
хиленький: хиленький 
фийон: Фийон 
ломакин: Ломакина 
известно: известно 
открыться: Открылась 
строгий: строгое 
бесплатно: бесплатно 
вяльбе: Вяльбе 
либо: Либо либо 
сокрушаться: сокрушаться 
подлеснов: Подлеснов 
тэг: тэг 
кошмар: кошмар 
голосина: голосину 
блокирование: блокированием 
еда: едой еда 
родиться: родился 
элитный: элитный элитные 
хитрый: хитрый 
финляндия: Финляндию 
карим: Карим 
универ: универа 
обслуживание: обслуживания 
слон: слона слон 
развязать: развязавшему 
возобновить: возобновить 
нулевой: нулевое 
исполнять: исполнять 
позориться: позориться 
конкрентно: конкрентно 
египетский: Египетские 
дивизион: дивизион 
тренд: тренд 
крутой: покруче круче 
корпоративный: корпоративного 
продолжаться: продолжается 
завуалированный: завуалированно 
покупать: покупать 
национал: национал 
ура: Ура 
кибер: кибер 
билет: билетов билеты 
устроить: устроена 
наркоман: наркоманов 
специально: специально 
надавить: надавить 
летать: летают 
отдыхать: отдыхать 
банька: Банька 
императорский: императорского 
блинкеном: блинкеном 
придерживаться: придерживается 
самохин: Самохин 
серохвостов: Серохвостов 
вывоз: вывоз 
красиво: красиво 
ангир: Ангир 
ссутся: ссутся 
уезжать: уезжает 
рустам: Рустаму 
обсуждаться: обсуждались 
ремонтировать: ремонтировали ремонтирует 
словоказывается: словоказывается 
заблокировать: заблокированному 
путилов: Путилов 
доступ: доступ 
распил: распила распилу 
комфортно: комфортно 
кот: Кот 
упростить: упростит 
свист: свиста 
приравнять: приравнять 
сменить: Сменить сменить 
глупый: глупом 
оформление: оформлением 
учредить: учредить 
томаш: Томаш 
совка: Совка 
эмоционально: Эмоционально 
талибан: Талибаном 
идиот: идиота 
заметно: заметно 
магазин: магазина 
халиль: Халили 
пробежать: пробежать 
молдавский: молдавского 
сопровождать: сопровождает 
обидеть: обидели 
чувствоваться: чувствовалась 
скандал: скандалом 
статистый: статисты 
неполноценный: неполноценными 
русяев: Русяев 
отодвинуть: отодвинут 
благополучно: благополучно 
обязательный: обязательным 
фасад: фасада 
надёжный: надежный 
мутный: мутную 
личность: личности 
сложность: Сложность 
настраиваться: настраивались 
окр: ОКР 
кондиция: кондиций 
подсказывать: подсказывает 
лал: Лала 
распределение: распределения 
твёрдо: Твердо 
девять: девять 
афганский: афганские 
номинал: номинале 
переломный: переломным 
пкр: ПКР 
холоп: холопы 
рухнуть: рухнет 
аэропорт: аэропорта 
солистка: солисток 
губерний: Губерниев 
должность: должность 
ответный: Ответные 
авторитетный: авторитетных 
дожить: дожили 
противовес: противовеса 
адекватность: адекватность 
советовать: Советуем 
хегстад: Хегстад 
удержать: удержат 
амф: АМФ 
бавария: Баварию 
преждевременно: преждевременно 
подключаться: подключается 
оказываться: оказывается 
российско: российско 
корабль: корабли 
утешать: Утешает 
довольно: довольно 
законодательство: законодательства законодательстве 
соблюдаться: соблюдается 
секретарь: секретарь 
яндекс: Яндекс 
противоречить: противоречат 
шествие: шествиями 
опустить: опустила 
эксклюзивный: эксклюзивном 
гавань: гавань 
реванш: реванш 
отрицательно: отрицательно 
подъём: подъеме 
спать: спит 
ры: ры 
откуда: откуда 
лягушка: лягушка 
солидарность: солидарность 
сдаться: сдалась 
защитник: защитники 
бур: Буров 
унизительный: унизительные 
исключить: исключили 
гол: голов гола 
лнр: ЛНР 
командником: командником 
сертификат: сертификат 
жаловаться: жалуется жаловаться 
познание: познания 
клиника: клиника 
освенцим: Освенцим 
косово: Косова 
авдеев: Авдеевым 
дельта: Дельта 
чен: Чен 
итак: итак 
минька: миньку 
эритрея: Эритреи 
ювентас: Ювентас 
наблюдать: наблюдать 
ясный: ясна 
максим: Максим Максима 
ценный: ценным 
прописать: прописано 
однозначно: Однозначно 
обобщать: обобщать 
вывести: вывести 
кипеть: кипели 
направлять: направляющих 
комплект: комплекта 
посетить: посетил 
глубоко: глубоко 
научить: научить 
нацсимволы: нацсимволы 
вестись: ведется 
сирия: Сирия 
ноль: ноль 
уууу: уууу 
финиш: финише 
классика: Классика 
утереться: утрется 
сибсканой: Сибсканой 
разыграть: разыграют 
ха: ха Ха 
отказываться: отказывается 
незаметно: незаметно 
режиссёр: Режиссер 
эда: Эду 
товащу: Товащу 
вытереть: вытерли 
специалист: специалист специалистов 
колледж: колледже 
кск: КСК 
ибо: ибо 
йорк: Йорк 
визит: визиту 
мирно: мирно 
свобода: свобод 
подозрение: подозрение 
слишком: слишком 
физ: физ 
закрепить: закрепить закрепил 
океан: океана 
полезно: полезно 
симпатия: симпатию 
позор: позор 
серёжка: Сережка 
оккупация: оккупация 
суметь: сумеем 
недовольный: недоволен 
испортить: испортил 
усложнять: усложнять 
мама: маму 
аят: Аят 
пожалуй: пожалуй 
отрицать: отрицаю 
ужасающий: ужасающую 
неспособность: неспособность 
чемпионство: чемпионство 
испытать: испытав 
репортёр: репортеров 
покататься: покатаюсь 
казань: Казани 
никосия: Никосия 
пакистан: Пакистан 
прецедент: прецедентов 
виза: визы 
райола: Райола 
отстаивать: отстаивать 
втбнба: ВТБНБА 
обычно: обычно 
лагрейда: Лагрейда 
загрузить: Загрузите 
видеозвонок: видеозвонку 
бишкек: Бишкеке 
установленный: установленную 
передумать: передумал 
сесилию: Сесилию 
медиафутболистов: медиафутболистов 
заселить: заселить 
мерседес: Мерседес 
ступенька: ступеньке 
сопровождение: сопровождении сопровождение 
греуто: Греуто 
горбачёв: Горбачевым 
сплотиться: сплотилась 
бессрочно: бессрочно 
лима: Лима 
ребёночек: детки 
степанов: Степанова 
перечислять: перечислять 
хотя: Хотя хотя 
выучить: выучил 
лето: летом Летом 
наставлять: наставляйте 
даритель: дарители 
кредитор: кредиторов 
аккредитовать: аккредитованная 
буся: Буся 
подождать: подождал 
стратегический: стратегическое 
унижать: унижать 
гадкий: гадкое 
положиться: положиться 
минниханов: Минниханову 
йованович: Йованович 
возникать: возникают Возникает 
скромный: скромна 
малограмотный: малограмотный 
потерпеть: потерпела 
блаженный: блаженный 
незнамо: незнамо 
прикрываться: прикрываясь 
уделяться: уделяется 
риа: РИА 
геополитический: геополитических 
алма: Алма 
опора: опора 
критика: критике критика 
гегемон: Гегемоны 
сформироваться: сформировался 
аккурат: аккурат 
нияз: Ниязов 
краткий: краткое 
стэйт: Стэйт 
хитросплетение: хитросплетениях 
эстония: Эстония 
травма: травмы 
игнорили: игнорили 
безропотно: безропотно 
превзойти: превзошли 
презентовать: презентовали 
концлагерь: концлагерь 
выбить: выбить 
ударить: ударил 
коммунист: коммунисты 
дружно: дружно 
ребятишки: ребятишек 
заходить: заходит 
внутри: внутри Внутри 
жоана: Жоана 
плакат: плакатами 
переобуться: переобулся 
осторожный: поосторожнее 
отчисление: отчислению 
уступка: уступки 
даллас: Даллас 
статистика: статистикой 
вместе: вместе 
порт: порта 
низ: низов 
двадцатка: двадцатки 
лить: лить 
сыктывкар: Сыктывкар 
китаец: Китайцы 
рассуждать: рассуждает 
бомбардировка: бомбардировки 
мытищи: Мытищи 
размещать: размещать 
коленка: коленке 
опытный: опытная 
дзю: дзю 
татарин: татар 
пасьют: пасьют 
холодно: холодно 
виктор: Виктор 
незаурядный: незаурядный 
прослеживаться: прослеживается 
титул: титул титулы 
петушиный: Петушиное 
сравнять: сравняем 
различать: различаю 
вывернуться: вывернуться 
записка: записке 
белград: Белграде 
отъезд: отъезде 
сусанин: сусанин 
жаба: жаба 
индивидуалист: индивидуалист 
фобия: фобия 
конъюнктура: конъюнктуры 
овертайм: овертайме 
оригинал: оригинале 
послать: пошли 
переиначить: переиначили 
предлог: предлогом 
решаться: решаться 
сравнить: сравни 
обмениваться: обмениваться 
испанский: Испанского 
костомаров: Костомаров 
оужаскакойкошмар: оужаскакойкошмар 
телек: телека 
омск: Омск 
соболезнование: соболезнования 
цепляться: цепляться 
учреждение: учреждениях 
рассматривать: рассматривать 
палка: палку 
англия: Англию 
дагестан: Дагестана 
ты: тебе 
понкратов: Понкратов 
годиться: годится 
артур: Артур 
высунуть: высунет 
пропускать: пропускать 
горевать: горюет 
репатриироваться: репатриируемся 
поспорить: поспорили 
стоянова: Стоянова 
домогательство: домогательствах 
наверное: наверное 
рон: Рон 
четверг: четверг 
тяжко: тяжко 
кузина: Кузина 
этодругин: этодругин 
херсон: Херсон 
век: веке 
прозрение: прозрением 
медиалигу: Медиалигу 
таки: таки 
мовы: мовы 
едва: Едва 
декларировать: декларирует 
классический: классический 
пожалуйнельзя: пожалуйнельзя 
брызгать: брызгать 
крайне: крайне 
прямиком: прямиком 
сармат: сарматов 
упрощение: упрощение 
раздумывать: раздумывая 
коммунистический: коммунистический 
связанный: связанными 
срочно: срочно 
мотивировать: мотивировать мотивировано 
тратить: тратил тратить 
приостановить: приостановила приостановить 
иначе: иначе Иначе 
судить: судили 
идентичность: идентичности 
подлеснова: Подлеснова 
увековечить: увековечим 
сплошной: Сплошные 
египет: египта 
мягко: мягко 
норвегия: Норвегии 
конь: коней 
гость: гостях 
медицинский: медицинские 
що: що 
эгриси: Эгриси 
заворачивать: заворачиваем 
пасс: пасс 
восьмёрка: восьмерка 
ограничивать: ограничивает 
назначить: назначена назначить 
щелчок: щелчком 
камера: камеру камерой 
жахнуть: жахнули 
днепропетровск: Днепропетровска 
хвалить: хвалят 
ду: ДУ 
бельгийский: бельгийском 
ассоциироваться: ассоциировалась 
анекдот: анекдоте 
людишки: людишки 
инициатор: инициаторов 
оценка: оценку 
перетасовать: перетасовать 
животик: животик 
прогревать: Прогревать 
иванович: Ивановича 
английский: английские 
бельё: белье 
вовсе: вовсе 
анализ: анализа 
нитка: нитками 
приостановление: приостановлении 
вылетать: вылетал 
обстреливать: обстреливала 
факел: Факел 
стиль: стилем 
адвокат: адвоката 
наплевать: наплевать 
голам: голам 
одесса: Одессы 
хаять: хает 
жезус: Жезус 
петя: Петя 
израйлитяне: израйлитяне 
приём: приемами 
спуститься: спустился 
зю: зю 
перекроить: перекроили 
повязка: повязкой 
неудобство: неудобств 
обзавидуется: обзавидуется 
поклонник: поклонник 
выгода: выгоды 
видеоповтор: видеоповтор 
югорск: Югорск 
иоланда: Иоланда 
пост: пост 
замерзание: замерзанию 
предел: пределами 
кр: КР 
обком: обком 
соперница: соперниц 
прославить: прославленный 
вряд: вряд 
колясочник: колясочников 
сервис: сервисах 
уефа: УЕФА 
недоедание: недоедания 
электорат: электорат 
ухо: уши 
экспорт: экспорта 
сирило: Сирило 
райзена: Райзена 
обратный: обратное 
уменьшение: уменьшение 
братушек: братушек 
обладатель: обладатель 
паразитировать: паразитируют 
стас: Стас 
жкх: жкх 
ивуар: Ивуар 
разбитый: разбиты 
захаров: Захарова 
вечный: вечное 
ласицкене: Ласицкене 
альтернатива: альтернативы 
владелец: Владелец 
тест: тест 
коллегиально: коллегиально 
соловьёв: Соловьев 
хамада: Хамада 
ишь: Ишь 
гадать: гадать 
чесать: чесать 
ограничить: ограничить 
обмануть: обманули 
объективно: объективно Объективно 
вскружить: вскружили 
обозреватель: обозревателем 
котельная: котельными 
развести: развели 
всемирный: Всемирного Всемирная 
быковщина: быковщины 
кипение: кипения 
самокритичный: самокритично 
позолотить: позолотить 
морозилка: морозилке 
покойный: покойного 
применение: применение 
полонизм: полонизмами 
задолго: задолго 
склонение: склонение 
тлетворный: тлетворного 
мигел: Мигел 
посмеяться: посмеялись 
отставка: отставке 
замять: замнут 
доказательство: доказательство 
наноситься: наносится 
бассейн: бассейне бассейн 
кремлёвский: кремлевские 
антверпен: Антверпен 
голубой: голубым 
скорбеть: скорбит 
приволжанин: Приволжанин 
нападение: нападение 
клоун: клоун клоуны 
увеличение: увеличение 
удивительный: удивительное 
рисунок: рисунок 
ноябрь: ноября 
истерик: истерик 
вечно: Вечно 
кабмин: Кабмина 
преодоление: преодоления 
занятие: занятие занятий 
дэн: Дэн 
ссылка: ссылкой 
орёл: Орле 
воевать: воевать 
сегев: Сегев 
прекрасный: прекрасные прекрасная 
нерв: нервов 
предугадать: предугадать 
равенство: равенства 
брусчатка: брусчатке 
угадать: угадай 
неполноценность: неполноценности 
платформа: платформе 
попкорн: попкорном 
жизнеспособный: жизнеспособная 
подарить: подарили 
способ: способом 
рецидив: рецидив 
провокация: провокация провокациям 
румыния: Румыния 
смело: смело 
фанат: фанатами 
прикол: прикол 
актуализировать: актуализировать 
нищий: нищих 
расстроиться: расстроились 
эрик: Эрик 
надднипрянщина: надднипрянщина 
майка: маек 
противостояние: противостоянии 
ружьё: ружье 
ый: ый 
жуан: Жуан 
папин: папином 
обойти: обошел 
соседствовать: соседствуют 
братец: братцы 
вручить: вручила 
триумф: триумфа 
критиковать: критиковали 
подразумевать: подразумевает 
теоретический: теоретических 
юлианна: Юлианна 
австралиец: Австралийцы 
продлить: продлить 
осипов: Осипов 
принципиальный: Принципиальных 
сталинщина: Сталинщина 
паразит: паразиты 
футболистка: футболисток 
лицензия: лицензии 
рвать: рвет 
обеспечение: обеспечения 
имитация: имитация 
делаться: делается 
перспективный: перспективный 
бусту: бусту 
исключать: исключаю 
космонавт: космонавтов 
вокруг: вокруг 
послематчевый: послематчевый 
свернуть: свернул 
безусловный: безусловный 
спорстменам: спорстменам 
жемчужников: Жемчужников 
средство: средств 
стеснение: стеснения 
заказчик: заказчикам 
безразличие: безразличие 
ради: ради 
эгида: эгидой 
творческий: творческой 
безопастность: безопастность 
женщина: женщин женщины 
медиафутболу: медиафутболу 
зашкаливать: зашкаливать 
десяток: десятков 
нынешний: нынешних 
рейтинговый: рейтинговые 
сшить: сшито 
отвратительный: отвратительный 
деятельность: деятельности деятельность 
рацион: рационом 
трейл: трейл 
транспортный: транспортного 
эксперимент: экспериментов 
повторение: повторения 
дистанцируются: дистанцируются 
природа: природе 
волюнтаризм: волюнтаризмом 
обеднеть: обеднел 
подсаживаться: подсаживались 
высота: высоту 
сыро: сыро 
распродать: распродали 
кардинально: кардинально 
карпов: Карпов 
минус: минусов 
ироничный: ироничную 
зарубежный: зарубежные 
красногорск: Красногорск 
дискредитация: дискредитация 
сознательно: сознательно 
способствовать: способствовать 
зара: Зара 
королева: королевой 
нападать: нападал 
диалог: диалогами 
нагло: нагло 
ныть: ноет 
гавгавовича: Гавгавовича 
комбинезон: комбинезона 
определить: определить 
сычёв: Сычев 
хан: хана 
побеждать: побеждаете 
пробитие: пробития 
экономист: экономиста 
лизнуть: лизнул 
газзаев: Газзаев 
поправка: поправкой 
анадырь: Анадыря 
складываться: складываться 
возникновение: возникновения 
убитый: убитыми 
сола: Сола 
муп: МУП 
словарь: словарь 
выезжать: выезжать 
физкультурный: физкультурные 
коля: Коля 
рекламный: рекламные 
выслужиться: выслужиться 
постоянно: постоянно 
предавать: предавать 
еврокубках: еврокубках 
согнать: согнать 
прогнуться: прогнулись 
ау: Ау 
олимпизма: олимпизма 
оставлять: оставляет 
подсказать: подсказала 
земляк: земляк 
выпустить: выпустят 
салют: Салют 
пенсионер: пенсионерами 
залог: залог 
четыре: четыре четырех 
необразованный: необразованное 
материальный: материальных 
параолимпийцев: параолимпийцев 
йоханнес: Йоханнес 
энергетика: Энергетика 
предвкушать: предвкушаю 
перечисление: перечислением 
сх: сх 
наглость: наглость 
временно: временно 
командовать: командуют 
угрожать: угрожают 
конференция: конференция Конференция 
ой: ой 
вклад: вклад 
лицемерно: лицемерно 
прессингуют: прессингуют 
респект: респект 
экстаз: экстаза 
верх: верхи 
чиновничий: чиновничьи 
подавно: подавно 
рунет: рунет 
шестой: шестая 
непонятии: непонятии 
бурятия: Бурятия 
мансийске: Мансийске 
гуманно: Гуманно 
всевозможный: всевозможными 
реинкарнировалась: реинкарнировалась 
антошкин: Антошкин 
задооолго: задооолго 
косить: косит 
медленно: медленно 
конкретно: конкретно 
играться: играется 
боец: бойцам 
китаянка: Китаянки 
норвежец: Норвежцы 
ликование: ликование 
пекс: пекс 
листочек: листочек 
госбюджет: госбюджета 
кожа: кожа 
находяться: находяться 
шаман: Шаман 
диуретик: диуретики 
подробный: Подробнее 
заключительный: заключительном 
ледниковый: Ледниковый 
михаил: Михаил 
исходить: Исходя исходят 
ротенберга: Ротенберга 
огонь: огонь 
жирону: Жирону 
палиться: палиться 
ведение: ведению 
хавбек: хавбек 
трофей: трофеи 
председательство: председательства 
впредь: Впредь 
подножие: подножию 
сопротивление: сопротивлению 
суть: сути 
сильно: сильно 
подмосковье: Подмосковье 
автоматический: автоматическое 
илья: Илья 
специальность: специальностям 
фехтовальщик: фехтовальщика 
просьба: просьбу 
гореть: горят 
обнаруживаться: обнаруживаются 
арбуз: Арбузов 
спешить: спешить 
отыгрываться: отыгрывается 
обогнать: обогнать 
заученный: заученными 
афонсу: Афонсу 
смсраха: Смсраха 
собственность: собственности 
трудно: трудно 
фратрия: Фратрией 
кук: Кук 
река: реки 
удалённый: удален 
следом: следом 
тасс: ТАСС 
либеропусы: либеропусы 
россиянка: Россиянкой 
удаваться: удается 
